1111111111
1111111111
111**1111*
111*111111
1111*11111
1111111111
1111111111
111*1111*1
*11*111111
11*1111111
