11**111111
11111*1111
11111111*1
111*1*1111
1111111111
111111*111
1*1*111111
1111111111
1*11111111
1111111111
