5**8777*777*9976*668*862**555377789*9*999999*89999***99*9**25*5352*1*5234*333231*9499978514*335*3366
5477677946**6*77*4*6674444**454958999999*9999*99*7*9**9*9964*12524422322*24*23329*965*5*186*13115323
556*766897*776*655*46*6755*5467*8899999*9999999994*9**9998*3133433421*44323*32*599964*313*3*68*25961
*5***74688*86**5666686758547*5798**99*999999*999*5999*9998*42333*3*323*6322*****99968841141**48781*6
5568*7**677886996*76*65566867689*999999999*99999989*9*9997*3*323*3445434424**259*99342544951*6565*33
557*768987767997777676767777**999*9999999*9*99999799999998*5254*224324243332**399998*73277959*834118
557*784677*78779988376767*6**79999999999*9989999989*9*99*844644333*133547*3*42199**94871*134**486*5*
547*98998*6487666*766*86*667769*999*9*999*9*9999*899*9999*39532*3231633243*23329999*71*426654855446*
5*8778***7**8*7767676696**8*8699999999*9999*99*9***9999*9*6661*3**224433332223799999**4253331697655*
647788868786759*7557876886866799999999999999999*788*99**98744432*23**3124*4241999*9997*611228118*565
54666679865555*56*6*79*968*5*7999999****99*999998*9*9999*893*3*23*2141111*5522987**999*789*9352*1*1*
5447887*777***446*6557*77667779*9999999**9999999799*9**99983735**363*4**23**2499**999921*4359*4844*6
545666876665*67655799676876568999998999999**9999*999*9999**7424**32*3211*23*29999999*9322*222879*765
*5589*989*75*655*6787****7785599999*999999*999*99****99996969*232**452473225398*999*99724121196*62*6
55476**89*67575*6*89*8887657689999***99999*999*999599999*394454161*3342*2***3979*9*999*3*1*5***85568
649*9999455456445*48997*895*6*9*9*99899999*9*9999*69*9*9*494*227*222**35222249*9*9999*9*962224787553
*5*998*795355566558*698847836999*999999999**999*99*9899**89896424352775*3564*67*99999982399971*57*57
5***6654455*5*345*3787*87**8699*999998*99999999**97699*999997**42*25541121265778889999***13*39*89322
55*664465**7766336*4577889767*9999999**99*99*9999996**99998866*471653212*447*99996999949572599249*75
5*65*463364*57564*6523676*4*6899999988*9999*9999**979999*98*4733854***733*16996***899955368*99319835
*557675477776666444*5437577***99*999*99999996999999789*99999777323***2*223**9442259692*2*315*32*5945
5*589534434***554*447*547477789*999*999989999**9699199**99995*65*147663*5*665643392*92748236*325*934
5598***8999952545*44*53456677699999*9*999999999969839*9*99*9**456673558676*814412*19*42383*426425854
*444*536**5566**54444354***568*99999999*99999999*985*99*9998668*6*56666677693**139*96*45613315513687
5*5*56435558*4**444**536*55*73*99*99999*999**9999*9599*99*99769977996776563*45145*2*44*356421262*585
556*444456676466445443**5455549*99999999999999*9**9*99999998*66566*4236*4468566593594426493*53321466
556*557888877**4*5445532*6*576***999*99*99*999*98998*9999*997*542436353*43*4*6**929934555834334*1359
5*57686766565654453554*5443554999999*99999*9999998*999899*999665*545*5*53256644173995545*6*2*4**4471
55557**6777**7*5**6*6*5**54*69*99999*999**999999*8999896999*9754*55*2*5568*625*1459*5557557556*1327*
6556*6*788665585*5*44434443668*99999*9*99999999*98999999999*99*32*6*736348477*51339676656*4333**318*
*5553*776**866*75437444*5556*56999999999999*9999999999*99*99995545**65449*459922*2**656**5*24*3*1294
655*7885854*5**46*55*45*66*565599999999*9998*9999999999*99998985*55554339148*96*9379776*662*2*1*2459
555666674*35367*6*7376357777798**9**99999998*88*9879999*9999*997**4454**964*69986**9*65*5*12222899*9
*57*5667887*55*8667*47635556699**99999999*999*999*99*9*9*99*999983*4375*1659***649985*5466*128665*49
**55986876*7876556*4*466*43*91***999*999*99996999*99*99**999989997*55461*5372***3999667***52*9649*89
655*7*7778*7677*53**686*7767*9*999999*999999989*9899989*999998*999*5*298**5323987998766565*666*73*99
*46678888877*8554*3*8838765*418*999*9*9999999999989*9999*99997999*9646549*3711**99*66*4**48*4*689***
657*788887*8764754*3686334798499999999999**99999*8***89*89999999*9998512*8389**999**359*996989997599
65556***8**67864787346898859699*999*9*9*999*699999999*9*99998999999949269949**9**998899*97**9*999*89
**7****679**8865**99*2778787193*99999*69999969*999899999*99978*99999776**1*245*8959998*9*821*7333321
6447797659*898566*47883543223984999999999*9*69997999*99*799999*9999799696**3**4**88*8788**16*766*414
**4*55**7568876367**88*23439995**999999*9999899*899999995999*99999997**9163352398*8978979*7*93**65*1
6***55*685335*76889878**9***9626999*999*9*989**99*999999*89999999999999816564359*99977897*99845***21
*4889968**78***5**5**77888838**6***99999999789999999999**689999999999989757544*779*6887*667782524531
6*999999*888667*8985*58777837362*99999*9998**9999899*99999979*89**99*9*995915677**888*8*89774212*3*1
6599999*9845666766*43335665972*4*9999999999*89999999999999*799*99*9999999922973486979888888957*31114
6679998999*677766646799889925422*999*999*9988999999699999999899999999999999346*999*96899*88411799899
*579**98999888*8888*8**888*5554499*999*999*99999999999*9999998999*9989**89*789*98*88899988988*86*777
6**9999999998888**888*88*7*467*699*9**99*9998*999999999999999989*9999989999987***9*877798*89*7288887
*499*9999*99*888898778*8891245**999*99999**9*99999999999*999**5999*9*98999996888876799789*8**893*698
*58*788*999*99*88**88689**244**89999999999*999999999999*999*997999*9999989999999*7975**88*9888797***
6488*999999*9998*9*8*8989962212899999999*99*9**9999*999**9***99999999998*899****6***9979*68*87683737
*489899999998999**99*99*965743**99999***798999999*999799999*9999999999*99**998878899998999799988*8*4
7*999999999999998*99*9*41294*47999999999999*99*8999*94999*99999999*99999*99**9988*7789*98*9787887894
*58999*8999*99999*9999998**8*99**99999*999*999994999*8*998*999*99999**9999*997**8**7**79994798888*97
*699999*99888*899999988999999999*9999*9999979999979**89999*9999999*999*9996999866699*89967747788*988
63*999*999*99**9*999988999*99*999**89*9*99*99999999899999999**99999*9999*969984768789999778788899989
64999*9*9999*****9898999*8999999*99*99999**9*9999999899*8999999999*999999*99*6887899899757666687*657
7*99*9**9999*9*99999999*9*9*9*999*99*99999999*9999*9979989999999999*9998*9998**78889999795556*8667*8
669999**9999*999999*9998*99999999999*9*9999899999998*999999*9***99999998*999*96889899968*77*7*799*75
74999999999*99*9*997998998999999999**99959*999999999799939*89999999*999899999988899*887*66445669**8*
7589*999*89988*99*9999*68*999**99***99997*99*99999999**9988999*99999999999999999999899*87762*2657666
75*99*99999999*89*9899987*9*9*99*999989997*5*9*7*99*9989998999*99999999999*9*9889*787886*775*55*896*
65*8*99*99*998899*66*998999999*99899*8999*9599989*999797995999998**9999*99*99*8*984657*66**8*9879**9
7*99999*99*9999*999*9*8899*9999*97999999999**999999999939999*99999999**999*99599*9998899989999979999
769*998*886888888768*88*99*9999998999*9899*99999*999***5999999997**99999**99**999*86777799*878*55779
7699888*998**788**789898*999*999**999*999999999999999999*9999999979*999999999999*77875*9767879989889
7688*89*778868*89999899889999*99999*999*9999999997***999*9999999***9999999999999998*87*9*77*7998**99
*5**888888878789888888788****999*9*999**9*9*9999999999*9899*9*999*9999999989*9*9**99*9*9878*999449**
768*8888*888789*8*8878889*9**99*99*99999**98****9999*99989999*999999999*9*9*999**85**6988888998*9*99
74*9*9898888*8*89*978989*9999*99999999*9999*99*99*99*99979*9*7**999599*99999*9*999*9**99999989989349
7998779*88999998*8999888*9*999999*99999*99*6*9*99**9999999*9899*9999999*9*9999899*95669999999*98965*
7*99898799999*9*89888889899*999*9999999*99*69*99*999999**99*8999*989999899999999999*99968**98999*449
8**9*9988*99*9999*988989*999*998999999999*97999999*999*99999*99*9999998**9*99999999999*9889*9***8439
79989998**9999*988*97*7*9*9999*999*999999999***99999*99999999999*9999999*999*999999*8797989*889**999
8*8999998*8**99*668*89889899*99*99999*89*99*99999999999**99999*9*8699*99**999**999**99988899*9*999*8
**9999889*888**97**677**7**999*9999***9**999**9*899899**9*9998889**9*98999999999*99*9999**8*89989988
7*8798***8888*899*7*76778889*9*899999999999999999*95999989*9*998999999899*99999*999999989*88*8*8*99*
779*898988999*99*999976*988**9*8*9999999999999**89999*99996999999999*9999999999999999999698997879999
***99*98878*8*9988999*8**8*9*99*99999999*9*9999799*9*9999998*9999*9*9499999**9999*999999789899998798
6588*99999*999**87778899998*999987989*9999999*999999*9999*989999*99998**9996999*9*99999*9*999989*999
7*99*9999*8889*988999*9*8699*9999*9999*999999999999999*9*99979*89*9995**9998*9999*999*9*99**79999*99
6**9**8999*8*9999977899*79999999999*6*9999999*99*899*99*69997898999*98*88*998*99*99999999*9999*9*999
69999999**98899978799**999*99999*99*9989999*99999999999**999999999*9**98989998999799*999999995889999
7**999999999*9998*998999*9*89996*9999*9999999999*8*99*99*99998999999*99378979*899999998999999*99*889
798989999*9*9997898**89*999999*9*99998*9*999999998*9999*99*9*8*999*99*9999*99999999**98**999*9469887
*999998*9*9999*7978*99*8999989*99***9**9999996999999999999*9*9999*9999999*99*899999***99999*99956724
79**98**9*99*989**87779*9**8*979999999999*9*999*899*99*999999999999999**99*9999999999**999999999*987
79999*99*799999*89*787898*99878999*99999*995*999899999*99*9*99*999999**999*9*8999999999*989999733777
*9**99999998*899896787797****8999*999**999989*9999999*999989*9*99999**9*9979*899999999999899**45***5
7*99*9999999*7899978**798999999989799999999**9999999999989999999*999*9*999999*8999*78899999*99896678
88999**99999*9799989968889999999*889*9*8999999**99*999999999999*999*99999999*99999*9*999*999998*8**8
7799989*99989*899*879*798*9*9889*9999999999*99**9999*99*999999999*9999*9*99*999*999899*9999**9976*67
8*6*99999999*9*89989999*98*998*8979999*9**99999*99*9*999*99999*9999*9*9*9*99999*99**999**9*99*9*668*
*99999*9*87898888999999999999**9879999*999*9**9*89999999*9789999999999*99*999999*99999999799*9889999
*9999*99*58799788*99999*9999999***9*99999*99999888996999*9879*9*99999*9999999*9**99999999899997999**
7999999999*899889899*99999999999*8899*999*99999*669898**999699*9999*9*999899999999999*9*9***97889899
**99999999*8*99899999*99999*9989**9989999999**95*8999999999999999*99999*9*9799999*9*9999*89999998898
799*9*9999*99*79**9*9999*9*99*98*98899999*9999969*9998***998*999999*9**9948898999*9999*99*9989789*99
*999989*9997*4777*76663*7879885577**8799**9999*99*99999*9997999799*9997*857*97*9999*988898994*98*898
