6665333333333333*344445444555*33*334*65*11*112211*1*1125554*444*45555445*55
66*6*3*3333333333344445444556*33*334464*11111222222212255554*454555*555*555
*66*3*333*3333433355*455*5555**44*4447*2*11112222222223*555*54445555555*545
*66533*33*33334*33544555455**344**45564311121*2222222233655554*455555555555
6**5333333*3333*33*455554566644444456643212221222*2222*3*655554455*555555*5
666633*3333**3*433554555556*3444*44465*3321211222223334*45*55*55555*5555554
**6653*3333*433*335555555664444444446544432222*22333344436555*555555*5*5555
*5666333333334343355*5556*5644*44445653443323333*4434*4*355555*5555555*65*5
555663333333333*43555555*6*544**44556535443444444444444434*5545555545555555
555653*3333334*343555555655344444*55654553344444444444443*5555544454566*555
555*63333333333343*55556665*445*4*565*455544444444444444445*55555555565*55*
555*6633333*33334355*5*655544544*5**6544*444444*444*444444655*5445555555555
555556333*33333343555*56*66445*4*55665446455444444444*44446555*545*5*555555
*56556**333333433355**665*6445544*5565444*554*44444**444446655*4455***55555
556666*333*33343*3*55665555*4555545665444655444444444444446554555*56555555*
55655633333*3*4333*556655*54455555566544445444*44*4**4*444*55555556*5556555
5555556333*333*3355*665565555**5556*65444*45544444*444444*655*5555666555*5*
56555563*22*33*3355566556555*5*555756644*44444*4444*444*44*5**666*666*65555
56555563222233334556655*6565555**565*5545444444*444444444465566666*6**65555
66555552222233335565655655655555556565555444*444444444*44455*66*6*66666555*
65555*5522222335556*65555*6*55555*6565555*55*44*44*444444456666666666**55*6
5555*55522222*4555665*555*6*55555*65*5555554544*444*44444*566666666*6666766
655555562222246566565*565*655555554565565*5545*44444*44444466*6667776767667
66555***53456*66656*5*5*556*55557555655*5*555455*5*544*444455666*77777*66*7
555666*66*545666656555565*65656666*566556555555555444555444665777*77766666*
6677666666666*66666655666556566**6556*5555555555554*45*54456666455*6*666*67
666666*6655666**66655*76666666665556665556*555555444*55544*65**655565566*67
45456666655666666665566666666675555666655*55555555444555545666**555*566*677
5*556656666556666666676666*66665656666656*5565*555*55555544666655***5667777
5555*555666*5666666*66666*6667*55556666*55555*55555555*5554*66665*66666*777
555*5555*666566666666666666**64*56566*67*55*556555555555**4666*666666*7*77*
65*555555656*66*66766666666*7556565666667555555565*55555545667655**6*677777
65555*5555666666*6*66666666765565556666666655555*666*655555666*666*6*676778
**6555*5555*66*776666666667*45**6*5*6666665*5555555555655556665766*77767788
66*65**55665555666666**6**544*65555*666666665565*55555566566*65667777777788
6665*5566**6665*6**5*656*55555*56566666*66*667656666*665*6*6666666677777*8*
76665556666666555555*5655545555*6666666666**6**7777766666*6*6656556677*777*
666*666666*6555*5555555555*5565*56666666666*666666666666666666*655666666666
666**6666666*5555*555*555*55565656677776666**666666666666666*66666666666666
676*666666665555555665556*55*55*66*444677666666**66*6666666666576666**66666
56*6666666666555*55665565655556744555*555*766666**6666*6*66666*577666666*66
*67666666666655555555566555565645566555555776666666*666*66666656*7666666666
65666*666*66655555566566*556665*43236655555767666666666666*6666667666766666
56*66*6666*66666*666666655666*43333*2466*55*776666766*666*666*666676766*666
656*7666666666666666*66*5*666*3*33*332566555*76666666666**66**66666776*6777
6566676666*666**666666*566666*3333333*3665555*76666*6*666666666*6657*767777
55556**666*6*66*6666666666664333*333*3*3665556*7*7*766666666**6666667777777
55555677666*66*66*666666667****3333333*3565*5577*66677766666666666*6*777777
5*555467766676666*66666666534344*333333346655*77*66*6777666*66666*666***77*
5**555545777*666*66*66666*444444433333*345655*576666666777766666*66*667**77
555555555457776*66676*666*4444*433333332346655577666666677766*6666*6*6*6777
555*5*555555*677766666664*44444*43333333*45*5*577666665656*76*6*66666666*88
*55555*5555555556665666544*444444333*333344655567776665556*777**676*6666666
5**5555555555556*6*666654444444443*33333334455557666665556667777*7666666666
5555555555555*55*5666654444444444333333*34546555*7*6*6*5566*56*7**666666667
555*55555555555*5*667544444*45443433*3333*344**55776*6555666666*77766766667
555555*5555555566*6664444444*444443333333344455*577*6665*66666*6*7777*66667
55566556*55555566666544*4444444*444433*333344*55**76666666*6666*66777776677
*55666*6665666666665*4444555544*444444333333444655*6*5*66*6666666667*7777*7
*566666666666*666*54444445555544*44443*3333444*55*665446666*666666667777777
*6*66666666666666555**4*445555444444*433*333*44*65*65555666666**66667777777
*6666*6*6*666676**544*4455545*444*444*433333*4*45*556555547*7666666*6787*77
666666*6*66*676*55444*4*5*4*554444444*33*333344445556*555567777766766678777
666**6*66666666*4444444*554*5*44*444*44333333**444656*5*555*7**777766667877
6666666*676*66554*444*45*55555444444*4*3333334444446*6655555*77777**6*666*8
6666666666*6*444545*4445*55555444*44544433333334444*656*5*55*4777776667*66*
66666676666644554*4444455555*54444*4444333*3343444444656655555577776667*777
66*767666*5444*4*54444455*555545444444433333**34444**3656*555565877767*77*7
6667666665**44544454*455*55*55*444455333333*334344443336*66555*55*777777777
*7666667444455455554*45555555**444553333333333344444333365665666*67*7777777
66666663*4*55*55455445555555*55444534*3333333*33*44433334*66665*666678**778
6666673444**54454*55555*5555555445543333333333333444333344**666666666688878
6*666344445545544*555555*5555554454*433333*333334444*3334444*6*666*7**77887
66743*4*4554544*5555*5*5*55*5555554433*33**333*333444333*4444456*7777788655
*6334*44545445**5555*5*5555555555*443*333333*333344*4*3*34444444*7778*5*555
