111*111111
1111111111
11111111*1
1111111111
11*1111*11
1111111111
11111111**
1111111111
*11*111**1
1111111111
