87889787*78778*7999988889*879779798787888*97899897798*999897
77898887798998999979978789778999979*77877*899799888*87797987
998798889988777978999988999789799987788799978798889889988789
89*9798998879789899779879999799887*797*788878778997777788778
88998887799787978879888797*79899799889978*77*989799789879889
9*88787799889987987789978997*8977899778787879788*98778897798
777899889979798979897877779999999898888889997798879999879988
98*8987898978*88897*98989977978897978*7788779979888889977898
978978897778*887899879*778878778799*989798899898897998897877
99998897779788877878797888*9988879879*8*87889979999899799877
89888887789887777797787979978788997798*898*78998878797999889
8988*89978*79987898887889997899979987*797988979788*789778879
877887977889*999999*987877798*9*8*99879788889778888777889999
78777797887*9998789779999799*9898997*78777987989789779789779
7879979787978*889*9889887*89998*7778977798887878997789998988
89889898877997797799797988988*798877888777779999**8898898878
87889987878899988777997877*898777899877997989887879899787887
9878797789998777*979788878889899789779878797978889978897787*
8778*87887888979*789898789879997999777787879798888887798*797
789779797778997998889979878989778999877987887778987999887879
87*99788988798**9*98*79889889988877*999987998888799999989798
9799987787*778898*89779797877*787977979889797*98888799778877
87887877899777979878878997777989*898777888979777899898997999
899*8998798977977989989787977897798897877877788898*987787779
799977998978977979798779899779778789*99877789998988879898*77
888779899789898997878*997*7797898988787777978977889778778788
97797779789*9*79998877787788889998779877897898779778979**899
987797889897889799879788797*7889877879*777987788777897788898
789799787888878779898*87788977897999987797897879988788999989
898877798897797999888798987997797779879977787889889777979887
979988888*7889998977797799778787999*887797898799978798779798
97*7898787797997897797888877777979798979899777*7878978987999
8788977999879979978989798987989787*7987899989*977977989899*7
7788877797779987978979877*79797*979989799878799999878*788789
8777999*897887877879789799879*77998799979*77877989*779989779
989*8999897*798898897998878998787889988778788797797998879898
98779*79*87879877**87999787779778997987999889887978977899897
7987887888977889787779879879*7*88999879*8*778799888988979788
*8989899877799989979978*879899877977888799799777877997988798
989*7887897797989979*77798787*9979*9877889878888778979888989
988999898987777897989898798778788797978788898788798887789978
*997897797977787789*8798897878777989999998*78777978979979798
877788799878*88777977987799979*79798989799779888878898789779
8798797888999987977887899888979789897879798888898*7787989889
998779778777989797798988879877878897978879*97789989779897889
78878979787987789987899899787889877877799897977*7879777*88*9
97899*98887777*89*978987*99898997778887789787878887777789889
7788978889988789979777789*797998897899797789898998879997*898
88978777*987798899978788987999997878898899779989898979787999
7799978989889899797899997897878899988788997798879879*7877779
998*7789897778999*889877788779787778799798788899899*99779987
8978789889977798797979889878888777897877878*8999879797899789
9*9779888979999*788888889897989797878977*7788977798879989979
9987997999988878978888887788*77888978*9877888788899897887797
989888997977987*9989878779799998*9979778889898*777898*977879
797789878*9889999877879788987899787997799889*7879**977797797
797877789978888797798997878898789798*77989998778779878788797
899899798*97*987778999*7979788779888887898999988898998787*99
787777977*889899879879978997997797978998899778899899*9787987
987978797777778888897799788979799779888797988797897798778778
