22222**2*222222222222222222***2222*2*2***2**222***2*22*2222*222*22222*2*2*2222*222*22**2*22**22222*222*2*2*22222222*2222222*2222**2222*2222222**2*2**2
2222**22*222*222222**22222***2222*222*2222*22*2*22*222222*2*2*2222*222222222**2*222*2222**222**2*22*2*2*222**2*22**2*2222**222222*22222222*22222222*22
2*2*222*2***2*2222*2*2*22222*222222222*2*222222*2222222***222*22*2*2**222222222222*2222*22***22222222222*22222*2222222****2*2*2222*2222**2222*22*22222
22*22*222*222*222222*222*222*222*22222222222222222222*222222*22**22*22*22222222*22*22*22222*22*2222222****22222222*2222***2*2***22**222*2222222222222*
*******22222222*222222222*22222*22222*2222222*222*22*2222*22*222*22*2222**222**222*22*2**222**2222222222222*2**2*22222****22*2222***22222**22222**222*
22*2222*22*2222*2*22*2222*****22*22*222*2222222*2*22**2222**2222222222***2*22*2*2*22222***22*222**2222*2*22222*222*222*2***222222*222*22*2222*2*2*22**
*22***22*22*222*22222*222**22222222*22222222**2*22*2***2*2*2**2**2***2*2***2*222*222*2223*2222*222**2222**2*2*222222*22***222222*222**222*2**2*22*2222
222222*2**2222***2**2222222*2*2*22*22*22*2222*2*22*2*22*22222*22222222**2222222***2*2222*2*222*2*22222222222*22*2**222222*2**2*2222222*222222222222222
2222222**2***222**222**2222222*222222*222222**2*2*22**2**2*222**22*2222222222*222222222***222*22****22222*22*2222**222*2222*22222*2*2222**2**22*222*22
2*22222222222*22*222222*2**2*2*2222*22**22***223*2222222*222222222**2222222222*2222*22222*2*22*222*2*2*2222**2222*22*2222222*2***2*222222222**22*22222
22**2222222*222**22222222*2222**222*2*22**222*22*22*222*22*222222*2*22*2222*22222***222222222222222*22222*22*2*22*222*222*****2222222*222*2*2**2222222
22222*222*22*2*2222*222222*22*2*22**2***22222*2*2222*****2222222*2*222*222*22**2222**222222**2*222*2*2**2222*222222*222222222222222222222222**222222**
22222222222*222*2222222*22**222222222222222222222222**222*22222222**222222222**222**2222222*222222222222***22222*22*2*222*22222*22*222*22222***222*222
2*222222222222*222*2222222222*2*2222222*2*22**2*3222*2222222222*2222**2****22*32**222*2222222*2222222*2***2*2*22*2222*22*2*222*2222*2*22*2*222222222*2
2222*2222222*22*22**22222*22****222*2*2222*2*2222**22222*2222222*222*22222*222**2*22*2**2*2**2**2*22222222**22222222222*22222***22*22*22222*2*2222*222
*22*2**2222*222222*22**2222*222**222*22***22**22*2**3232222222222*222*222222**22*2222222*2**22***22*222*222**22222**22*222222*222*22222**222222*22222*
*222*2222222**2***22*2***222**22222222222**22*2**233**3*232222*222222*2*222222*222*22*2222222*2*2*2**22***2****22**2*22222*222*2*22**22*222222*22*22**
2*22*222222*22222222*2222*2*2222***22*2**22**2*22**3***32**2222*2*222222*2****2222*2222***222***2*2**2*2222**222222222222****22*2*22222**2*2*22222*2*2
2*2***222*22222*2222*22*22*2222*22222222222*2222*23*33333***22*2222*22*2****2222*22*2222*222*22*2**2*2*2222*2*22*2*2**22***22223222*2*22222***2222*222
222**2******2222*2*22*2*22*22222*2**22222**222222233**3*3**3*222222*2**222**22*22*222**22*22*2222*222****222*222*22*22222222*2**2*222222222*22222**22*
**2*222222222*22222*222222222*2222*2*22222**2*22222333343*3*3222**22**2*222*22*2222*2*222222**222*22222222*2*2*22222222**22222222222*2*22*2*222222222*
***2222***2222222*22*2*222*222*222222*22*2222*222222*3**53*3*3*3222****2222**2*222*22222*222222222*22*22*22222***222222222***22222*2*22222*2*2*222*222
2222222*22222**2**2222222222222**222222*2222**22222**33433*344343322**2*22**2*2222**2*22222222**2222*2*2*22*22*2*2222**222*2*222*222*222222222*22*2222
222*222222*22222*2222****222*22*222222**2*222****2*2*33*3**3444*333332222*222***2*2**222222*22*2222*2***222**222***2222222*2**2222222*222222**22222222
22*2*22222*222222***22222*22222222**2*2*2222*2222222233333*4*5*4*33333*222222222222222222222222*2*2222222*22222***2*22222*2*2*2*2222*22222*2*222*2*2*2
2222*222222*22222*222222**22*22*222*2*22**222*2**222*23*33*4*4*4433*3333222*22*22222*2*222222**2*2222*2222*22*2222**222*22222*22*22222*2*22*22*2222322
2222222222222*2222222222**2*2222222*2*22*2*22*2*2*2*22*333**45444*333*333*22*2*2****2222*22*222*22**222222222*2222**22222322*2222*22222*2222*2222*2222
*22222*2**222***2222222**222222*22222*2**2*222***22*223333*4*4*4*4434*333222**2***2*2*22*222222222**2*22222*22222222222*22***2**2222*22*2*2222*2222*2*
22222*222222*22*22*222*2*2*222*2222**222*22222222223222***4*4*5*44**4*33*2**2222*222222*2222222222**22**222*22**22*22233*2*2*2*22222222222**22*22*22**
22222222222222*22222***2*222**222*222*2222222222222222323*3*44554444444*332*222**222**22222*2**2*22*2222222*222222222223**22222*222222*22*22*22222*2**
*2*22*2*222**2**222*2*2*2**22*22*2**2*2222*222*2*22*22****3**44*45**44433*3**2*2*22*2222**222*222*222222*2*22222*222222222222*2*22*22*2***2222222*2*22
222**2*2*222222*222*222**2**22*2222222*222*2222*2*222*22**4*45*44444444*33*32*2222*2*222222**22*2*2*222*2*222222222*2*332*22222222*222*2*222222222*2*2
222222*2****222222*22***2*2222**222**222222*22*222*22*2223344*44445**5*3333**2**2222222222*2*222222**2*2**22*2222**33332**222222*2222*22*22*22222**22*
*22*222222222*22*2222*222222*222***22*222*2***222*****22*3**344*44*55*443*33*222222*222222222222*222*222***22*2**222*22222**2222**22*2222*222222*2222*
**22222*2*222**222*2222222*2222222222222222222*2*22222*22233*344444*5*44433*332**2222222*222222*222222*22**22***2*23322222222*2222***22*2222222*222*22
**2222*2**222222*222222*2222*222222*22222*222222222*2*22*3333*3*444*45*4*333*3**222*2*22*222*222*22**2*22**2222224***222*2*2*222222222222*222*2*222222
2**2222222*2**22222***22222222222222**222**2*222222**22*2***3*34*44*****3*3333333*2***222*22*222**2222*2*22**22*322*23222222***2222*2*222**2222*22*222
222222222222222222**22222*2**2222*222*22222**2222222222*2232333*3*44*44444*33*3333222222222*2*3*222*222222*22232233*2*2222222*222222222****222222222*2
22222222**222*22222*22222222**22*2*22*222*22**2222222222***33*33*3*444444434**33333*2*22*2222222222*22**2*2*22332*2*222*222*2*22*2222222***2**2*222222
222233333*232*2*22*2222*22****2***2222*2222222222222222222*233333*4444444444444333332*2**2*2*222*22*222*222222332232*22222222*2*22*22*222**22***2**2*2
2*232323**2*3*3*22222**222222222222222222222**2*2222222****2*3433*3***4*44544*4433**32222222*22*2***2**2*222*23***222*222*222*22222222*2*2222*2***2222
*33*22*3333333*2**22******22*2*222222**2*222**22**22*2*222223**333*33344344**44**33*333222**2*2*22222*22222**33333**222**22*22*222*2*2**22222*2222222*
23*3333*3333*33*3332*222222222**22222**2222*22222*22222*222*22*3*3*33**4444*544543333332*222*222*23*22332*3*33333222**222*2*22222222*22**2**22**22***2
3**33*3*3*33333333*3*23222***2222*2*22*2*222***22222222*2**22222333333344**4445*4433*332*2222222*3323*33*2**333**32*2*3222***2*2*2*2*222*2*2222222***2
*3333*3*3**33333***3*3322*2**22*22**2222222*2222*2**2*22222**222233***3433444*54**4*3*33223*2*3323*3333333*3**3**2222222*22**222*2222222*2222**2**2*22
3**33333*33333333*33*333322*22**22222222**2*222222*2222**222*222*23333**3334*4*444433333333*2333**3*333333*3333322*2*2222*2222*222*2*22**22*222**2*222
3333*4*4*3*3*4*33*3**33****2**2222***2*2222*2*2*2222222*22*322**22*3333333*34*44*4*43**3333*33*33333*33**3333333*22222*2*2222222222*2**22*222*22*2*2*2
3344*4343****43*3*33333*3*322**2222*2222**22*222*2**2*22*22**22**2*33*3333*33*4444444*3333*33333333***33*333333*2**222*22*2*2*22222222222222222222**22
3**4*444664444*4*33333333332222*2*22*22222**2222222*2*22222*2*22*22233**3*334444444**3*33333*333333*3333333**232222*222*222*2**2*22*22**2**2222**222*2
44**444477444*44*3*333*333323222222*222222222*2222*2*222222222*2**22233333*333**4*444*33***3*3*3**33**3*3**3**22*222*222*222*2**22222*2**2*2***22*2222
444*444*544444*444433***3*333**22**2***222***2222222*22222**222*2****33*3333343*4444*3333**33333*33333****333222*222*22222222222222*22*22*22222*2**222
4*44*4*55*545444*4***3333333322*2222222*22*2*22*222*2*2*2*22*22*22222223333*34444444443*3*3*3**33*33333333**22**22*22**2*2*2**222222*2*22*22***2222*2*
4*44**55565*55544*444*******3322*2*2*2222222222222*22*222*2*222**22222**3*3*3*4444**4**4333*33*333*333*333*2*22222*2222*22*22*222*2*22*22222*22*22*2**
*45*5555665555555444*333*3*33**2*222**2222*22*22**2**2222*2222222*2*22*333333***4*44*5444**33444*3*33333*22222*2222222222222***22222*22*2222222222*2*2
*55*66667**7*655*54444*333333*2222222222*22*22**2**2*22222*2*2*2222222**3333*3*444444445*4443453*3*33*33322*222*2**2222*2*42*22*2***2*222*2*2*2*222***
5556667*77*776**55544**33*33332**22*2*2222**2222**2222222**222*2***2222*333333*4****444***44**3*33*333*322*222222232222222222*2*22222*22*222222222**22
*666*77**888*87665*5*4443*3*****222***22*2*2*222222*2222**2252222222*22*2333333*4*4**4455***4*33*33333*222*****22*2*2222*2222222*22222222**22222*22222
56*789*99**99*8***55*4443333****2222222**2*2**222*222*2**22*22222222*2222233333*4445*54**44*43*33*3333*2***2**22**2*2*2*22222222*22222222*222222222222
6689*888888*8899**5544443*33333222*22*222222*2*2*2**2222222**222222*22*22234**3******55554444333*333*3**222232*2**22222*22222222222*2*2*2*22222222*22*
*888**9999*9*8***87*54443*333332222**2*2*2*22*2222222*222***22*222222*2*2*23333*44*55555*5*44***3*33333*33232*2*222**222*2*2*2222**2222****222*22*22*2
*7**8*99*99998887*755*44*333333*2*2*22222*222*22*2**222*222*22*2222*2*22*233*33**455*556*55544433*3****2323222*2*22*222**22**2*2*222222*2222*22222*22*
7*889*99999*989877***44433*3***2222222222*2**2*22*222**22*222*22222*222222*2*3334*4**666*7554**33*33323222322**2**2222*2*22222**222222222***22*22222**
688*999999*99898*7655*44333*3332*2222222*22*2222222*22*222*22***2222222222223*3*4***66**6*6****3333*3333233**32*2*22*2222222222**2*222*222222222*22*22
68889999**99*89*766**44***333***2*2222*22222222222222222*2222*2222**22222**2333*3445****6*654443*33333332*322*22222*2*2*2222222*222*22*2222*2222**222*
*7*88999*999*898*665**4**3*33*3222*2222*222222***22222***22222*22*22*2**22**33**344**7976**5*443*33*3*33*3332**2222222*222222222222***22222*2222*22222
*78*7899*99*889*766**444*33**33222222*2*222*222*2*22*22222*222*22222222222222*33344556666*5*544*3333*3333*33*3*222****22222222**222222***22*2222222*22
5677**88888877**65*5444*3*3333322*22222**22**2222222222*222222***2222222**22*2333**45*558655544433*3333333333333222222*2222222222*22***22*2***22222222
*667**7*6*6666777**5**4*3333*33*2*2222*22***2*222222*2222**2*22222*22*222*222**3343*4555555**44*4333333333**3333323222***22**2**22222222222222*22*2222
4*4*5*555444**455*44*543*3*33*222*22*22222222*22**2222*2222*22*222222***2*222**333434444444454**4333*3333333333*22322*2***2*222222222*22222222222*2222
44**44444444**455**55433*333*32*2222*2222***2222222222*222**222*2*2222**2***22*33**3344*44*44444**333*3*3*333*333*32*2*222*222**22*22222222*22***22222
4*444444444444*4444*434*3333****2**2*222*22222222*22222222222*2*222*22*22*22222*333334344444444443333333**333333*333222*2*22**222**322222222*2******22
44**4444***444*444444*33*3*332**222222222222*22222*2222*2*22222*2**222222*2222*33*333**3*3*4*54*443*33333*33*33333233222222*2*3233*32*23*2*2*222*222**
44*44*4434444445*44*44333333322*2*2*2*22*2*2222222*2222*222222222****22222222**3*33**3*33**4444*4*44**333333333**333*22322**3**33333233**2*22*2222*222
*3*333**4444*33*3**6*3433333*22222222**22*2**2222222**2*2*2222222*22**22*22222223**3333**3334445443*3*33*333333**33**2332*3*232**323*3***23*2*2222*222
3334*444*4555***55*434*3333**22*22*22*222**2*222*222*2222**2***2*2*22*2*2222223233333*333*4344**4****33**3333333*3333***2223*3*33*33333*32*2*32322*222
3*444333*3*3*4*544*44**343*2*22*22**2*22222**22222***222*222*222**22*22*2**222333333*3*3333**444**444*333**333*33*3**3333333*33323**3223*3**33*2*222*2
33*3*333*333333*33*444*3333222222222*2*222222222222*2222*22222***222222222222****3*3**33334333444444*33333333333*33333363*33333**23*223**222*33**32222
33*33*3333*3*3333**34**3322222222222**222222222*222222*2*22222*2*222222**22*23*333*3333*33333*44*44**433*33*33333*3**3**33**33333*22*233***33233**33*2
23*33334555455*33333**243*222222*2*222222*222*2*2**22****222222***332*22222*23*3*3*3333*33333***44444**333**3**33*33*333333*3***33*332*32333*33*33**33
*333344455555*555433*3322*22222222222222*222222**2222222*22*22*3*3*3**2**2223*3*3**3*33*33*3333344444433*3333**333333333333**3333**322*333*33*3*333333
33333*44*555555555*32222*22222*2*2222222*2222*22**22*2222**2233334*333323**5*33333*33333333333*4444*444*33333333333333333*33*3333323233*3*3***3*33333*
*3***34*4*55544*5**2222*222*22**2*22222**2*2**222222*22*2*22**334933*33323333333*333*33***3*3333*444*4*33*****3**333*3333333**333*2333233**3*3*3***33*
*2332*34*55***365552*2**22222222*2*22*22222*22*2222*2222*2*33*479*333333333*3333***3*33333**33*344444*43*333*333343333333333333333*332333333333*333333
22332*344555***65***2222*2*2222*2*2**222*2222*222*2***222*2*33599*3*33*33*3*33*33**33*3***333***345444*4*33333*3*4*3*33*33*33*333**33333333*3*3*3**333
2*33*2345*55*3465**32*2222*22*2222222****222*2222**22222*22*333**763*3*3333**33*3333*33*333*33*33**4**444433*33**33333*3*3***3*333*3333333333333333333
3233**44455*55555553*222*222****2222*222222*22*2*2222*22**233338333*33*33*33*33*3**3333*33**3**333*444*444*33*3333333333*333333*3333*33333*33**33*3333
*3*33**44555555*5**3222*22*2**2**2**222*2*2****22222222***23334333*33*33*33333*3*33*333*3**3*33353*44444*4**3333**443***3**3*33*333*33333*3*33*3333333
2*2*3**4*55*555*555*22**22222*222*22222222*2*22*22222**22*323*7*333***3*333*3333*3333*333*3*33353**44**45*4********4433***333**333*333333*3*****333333
222*3*44555*55545*54*22222222222*2222222222*22*222222*2*22333333**333333*3***3333*3*3*33*3*33*33334*444*54444433*34*44*3*33**3**3333333333333**33333*3
*23334445555*5555554222***2*2*2*3222*2222222*2222222*22**2*33333333**333333*333333333*33**333*3333***4445*44443334*44433**33**333*333*33*3333333*33**3
2233*4**5555555*589622222*2*22**222222222222222*2**222*2322*33*3*3**3333333333**3**3333333*3333*43*444444*44*4*344444**3*3333*33*3*333333*333*33*333*3
2233*44**5*5****99**222*2222*222*22*2*2222222222*22222222*33333*33333*33*33333*3**3**333333**333*344444454*4*4444444444343*33**3*3*333*33333***33**33*
33*34****555**9*9***32222222222**22*22222222*3*222*22*23*3*33333*333*33333*3*33**3*3333333***3*333*4***545*54**44*44*4**4*3333*33***3333*3*33333333334
333*4*4*5*57*9999*99**222*222222*2222*222*2**222*2222222*3*3333333333*33333*33*3*33**3*33*5333*3**444*454554444444*4**44*443*3*3333333*333333*3333*4*3
3*33444*549999*69**93223222*22222**2*222*2*2**2232222*32*333**33*33333*3333**33*3333**333333333*33*444444*55*4*44***4*4444333333*33*3*3*3*3*33*333*333
3333444499*9996*99*93*33*22**22*22*****2222222**22*32*3333333*33*33*3333333333*333*3333336*3333333444*444*5554*4444**4*444***33333333*3*3*333*33344433
333*3*78*99***9*999933*3333*3*2**222*32*222**22222333333*3*3333**333*3**3*3*3*33333*333373333****444**444*5554*444*4***44*4433**34*333333*333**333**43
333368*889999999*99***33333*3333332*2*2222223**3**333*3*33333*3333333333*33333*3*33*3*3533*333*3*43**4444*5555454444**4*444*4*4*44343*33***33*3*434333
33*77788*8999*99****33333**33333*3*33*3323*33*3333333*3**33*333333333333**33*33333333344**333*33333*444**455555*4***554444*44443333*33333333*334444433
3**677*8899**9*99*99*333*333333333*333*333333*33*33*3*3333333**33333333333*33333**3**36*333333*33*44444*45555*555**45554*4*44*44**444*33*3333**344*333
4556*488****9999*9*93***33333333333*333333*3333*333333**3*33333**333*33333*33333333*353*3**33*33*34*4*44*55555*555555*55**4*4444*3*4*44344*33*3444*3**
45*5*3888899999*9999***333333333*333*3333**3*333**333*333333*333*33*33*333333333*3337333*3*333*334444*44445*5555**5555*54444444*444*4**4*4**3444**3333
*5564*888899*9**999*23333*333**33*33*333*333333*3333**3*3**33333*333*3333333*33333*7*33*3*3333*334*4*444455*5*555555**555**4**4*4444****4***444433333*
*5***4*8*89*9*99*999*33*3****3*3**3333333333333*3*33333**333*3*333*333333333*33334444**3*33*33***4444*4**55*55*55**55555*54444*44444444**4**444433*333
45**55*888**9999999933333333**3*3*333*3**33*333333333*3*3*33333**3333333*333*3*3*49443**333333433*444*444555555555555*555544444444444*4*444444*4333333
45*7*788*89*999999994*333**3333*3333*3333333*333333333*3*333*3333333333333443*4*494*44**4**334444***4*44*5*5*55*55*555***4*4**4444*4******43433*33333*
**677778889*9*9*999*5*3*3****33333*3**3333**33*3*33**333333333333333*33**4*44*4*944444*434**4444444444445**55*5*55*5**5444*4444444***4444*444333**3*33
5*677788**89999*99997**33333**33333333333**33*33**3*3*3*3*333*3333*3343***444449*44*44444*444*444444444*5555555555**5*444*4444444*44444444**333333333*
*5677*8**88899999*997333333***333333*3333333*333*3*33333333*333333*3*4444*4445884444***44*444444444*4*4***55555555555*4444444*444444444**34***3**333*3
55677*7888**99**999***3*3*3**333333*33**3**3**333*3333333333*3333*4*444*4*5*57*544444*44*4**4444444444*555555*55*555***44*44444444**44*4443433333333*3
5567**78*889*99999999*33333*3333333333*333333*333333*3*3*3*333333*3*44*44**76*55*44*4444444**4444444444*55*55****55****4444*4444*44*44*44433*333*3*333
*567**7***9*999*9999933*333*3*3333334*333*333**3*33333*33333*3*33*3*444*45699*55**444*44444444**44****5*55555**55555*4444*4*44****4444*333333333333333
556*77888899999*9999*33*3****33**333*3*3*333*3*33**333333333333*34444444556*865544444444*4*44444*44*44**5555555555*554****4*444444444*34334343333*33*3
*567**7*8*8*999*9*999*3*33333*333333*3*3333333*333*33333*33333344444*4445579*655*4*44444444*44**4*444**5*55555**555**54**4444**444*4444*434333333333*3
*5*77*22**8*999*99999**333333*33*3*3*33*333333*3333333**3333344*4444444*5*95*5554444444444444444*4**4***55666*65555655*4*44*4**44444333434**3*33*333*3
*5677*33*889999999*99*33*3333333*33333333**33333*33*33*3333*3*34444444455*55***544*44**4444444444**4455*5*6*6666*66556444******4**4*4*343343*33*3333**
*5**774**8899*999**9*43333333**33*333*33*333**33333333**3*3*3*4*4**44*45855***5544***4*44*4444*4*55*55*556566*6666*55**44*44*4*4444*4434343333**3*3*33
556677776**999*9***9*53*3333333*333*333**3*333*3*3**33*****44*444*444*58755*5*54*4*44*44**44444*55555***56566*66*6*66***444*4444*4444*4***3*3*33**33*3
*5*7777**88999*999999733333**333*333*333*3***3*33333333*344444*444***5*7*55545444*4444444*444445*5*55*5*5*5*5666*6*66665**4444*4444344444*433333333333
***7*78*8*889**999*9853333*333*33**33*33***33**333*333444*4*4*44*4**55*55*454*44444*44444*4444555**5555*5555**656666*666444*44*4444***44444*3*3***3*3*
***7***8*889*999*9*65**3*3*33*333**3333*333333*34344*444444***4*44*4*9**45*444444*44*44*444444*555*5*5**555**66666666*664444*44*444*4444444333333***33
*5677778*889*9*995**553333**333333*3**334*44*3434**444444*444444444*84**55*4*5444444*444*4*5455**55*55*555**66*6*666655444444444444**34**4**4*433*333*
*6677788888*99*6*55*55333**33*334**4*3*44434*44*4444*4*444*4*444444**55455544*5544***4*4545*55555*555*5*55566666666565*4*4**4*4**4434*44*43*443*3****3
*567***888888**555555*3443334*44**4*444***4444444*44444444*44*444445545***5*555545555*45*5*5*55555**5555555*****66**54444*4*44**4*4444444444*4****33**
*6677*788*8**5*5567**543344*4444444*444**44**4*44*4**44***44*44**545*555555*55555555**5*555*5**55555*5*5*555*66***6654444444444444*44444*4*4*34*3**333
*667*778*655*55*556555*4*4444*4*444444444444444*4*4444444****4454*55*555*55555*555555555*555555555*55555*5556**666*64****4**444*4***444*44444*3**43*3*
5667***4*45*55555645*54444444444*444*4*44*4***444**44***444455555*55*5555555*55555555*55*5*5*55**55**5555*5*55**666*44**4444444444**4444***4444444****
*667*44444**55****45*54***4*444**444*444*4444444*4**4444*445555*55*55*55*55*55*5**555*555*55555555*55555*555*565666*444444*44**4*4*44444*4*4*3*444*3**
566*3444*45**55*55555**444*4*44*4*4444444**4***44**444*4*555555555****5*55555555**5*5*5*55**5666*6667**76555*5565*6654444*4******44*444444***444***333
543**4*4445*55*555**554444*444*4444444*444**44*44445*455555*55**5*55*55*55*5555555*5*55555656*6*77**7*77777554444444444**44*4*4*4**4444444444*4*3*3333
333*4444445**55*5*55*544444*44444**4454*4*4444455*5555555*555555**5555555*5*5*55*55*55*55566*6677*7*77**7*755*4444*44*4444*4*444*4*444*4*444444****3*3
333**444*4555*5*55*555544*4444444*4**4555555*5*555*55*5**55555555*555*555*555555*55*555*65**66777*77**7*77754***4444******444444444*444*3**333333*333*
3*3**44**455555**555*55*44*4444*4444555*55555*55*5*555555**55555555555*555*555*555555555*6667****7*7*77777*444444*44**4**4444444**4*444333*333333333**
*3*3*444444555555**55*54*44*4444**5*5***5*55555*5555*55555**6*56*6*55*555*555555***55555*66*7**7777***7*7444444*44*444444444*4**44*444**3333333333*333
333**444444555555*55*5544444****55*5*55*55**555**5**55***566****6*65***6555**5555555556666*6*77*77777777444444**44*4444444444*444444*****33333***3333*
*3*434*4444555*5555*5*54*444454*555*5555*5555*5*55555*6656666****6*666*66655**65*556556*666*6*6****777774*4*4444444*444*****444*4*43**3*3*3333*3333333
3*33*44*44455555555555544*4555555**55**555*555**6*6565****6*666666*666*66*5*65*565666*6*66*6666*7***777744444**4*44***44**444*44*4433**33*333****3*333
33**344444445*5555*555*445455**5*55555*5*655666666666*6666666*6*6*6*6666**6666*66*56*6***66666***7*7655*4**44444444*4444**44*4*44**43333*3*3*3333*3333
33333***4**445555*5555**5555*5*5*5**5*5666*6**66666*66*6*66*6666*66*666*66666666*6666*666*666666*7*75*555*4444*4444**4*444*44444*343*33333333333333*33
3*4**4*44444455*3335555*55555555*555565*666*666666666*6666666*666666*66*66*666*66666*66*6*666655*775**5555*4*4444444444**44*44*443433333*333333333***3
**33444*444*4455*23555555555*5*55*55*6666666666666***666666666*6***66666*6*6*666*6**666*6*5*5555*6**5***5*444**4*44*44444444*4*4443333*333***333*333**
323**4*4444444*53335555555555*55665666666**666*6****6*667*6667*667*66666666***66*666*66**555555*555*55*55***44*4444*4*4444*44444*44**33*33333*3*333333
***3*344*444***5*3355555*555*55*6*6666666*66*66*666667*766776*77776666**666*66666666**66555*****5555555**4**4*444**4444*4444444*444*333**3*3*****333*3
33333**4*44**455*55555*5*5**566*666*6666*6666666**667777*7*777777*7*776***666*66666*7776555**5555*55555*555*4**44**4*4444******4**4*3*3*333*33*3***33*
3*33**344*4*444555455*555655**66*66666*66666666*66*77*777777*777*77*6777**6676677**7*77655***555*5555555555*4444444444*44***44444*33333***3*3**33*333*
33333*34*4444445*5*55555*5*66**6666*66*66**6*66767777*77*7***77777*777***7677776767777**655*655556655*55**5444*4444**44444*4***443*33333**33333**33**3
333*3333444*44455**55555*6*6*6*666666666667667**7777*7777**7*777777777*77777*777*77777766**556**66654455**544**44**44*4***44444*4333*3*3333***333**3*3
**333333*444*4**555*55556**66*66*6666766*7777**77*7*7**7*7777**7*777777*7*77*7777777777*6*666*6*6*4444*4*5*444444*4*4444**4*4444*333333333*33333*33**3
*33333333*44333*555**5556*66**666*7*7667**67777**777*77777**77*77*7777*7777*7*777777*777*66*544564**4**4*444**4*4444*4*44*4444*433333*333***3333*3**33
33*333*3*3333**5*545*55*666666*7677666*777777**77777777777*777**77777*7*7777777*77777777*755444**44******4444444*444*44444*3**43*3333*3333***3333*3333
