*2222**23*333333*33**333*33*333333333*333*33*33*333*333**33333*3*3333*333*444*6*6****444444*444*45545555555*56**66*6666*666666666**666666*66*6**333333
*2*22222233*3333333*3333**33*33**333333333333*33333**3*3*33*33*333*333*3**4*445*6667*44444445*4555***55555*5*55*6**6***66666***6*6*767**6666**3333*333
22222222223*333333*3333333**33*33*333*333*3*33*33333333***33**3333333*33***4**455556*6*45556*77*55*555*555**56**666666****666***6*77*66666*666*3333*33
222222222**333*3333*3*333333*333**3*33**3333333333*333*333*3333***3**3333*4444*555556*5557777*77*55555**555*56*6666666*6666*6**66777*6*666666*323333*3
2*22*2*2*2*23*333**3333*333*3*33333333**33333333333*333333*33*333*3333**4334444*5555*7675***7**777555555555556*6*66**6*66*6766*777***67*6**6532*222233
2***22*222223**2**33**333333333***33*3333*3333**3**3*333***333333*33*33**434444*5**55666*66*6***7775555**5*565666*6*66**6*666*77777*7*77****322*222*23
2222*222*2*2222233**333**3333*3*3333*33*333333333***3333333*3*3333*333**3444444445**556666666***777*555*5555*6***66666*6667*7777777777766*6*322222222*
2*222222*22*222*23*3333**33333*3*333***33333333*33*33*3***3*3333333***3334**444*4455*5*6*666*6667*77555555555566**6666*666***7**77*7777777*5**22***2*2
22*22*22222*2222323*33333**33*333*333*33*333*3*3333333*333333*33**333333***4444*4445*56*66*666**77*65*5***5*66*666*6*666***677*77*777*7***6**2*22*22**
222222222*2*2222*23323**3**333*333333333333333333*3**3333*3333*33**3**433344444*4**5556*6*6666****775*55**55*66*6*666*67676777*777*7777767633***222***
*222*2*2*22*22222*3*3*32**3333333*333333*333*3333*3333333333333333*****34344****444555*66*6*6666777775*5*7**5*6*66666677777777****777*7766*3222*22222*
222*22*2*22222*2****22*3**333333*333333**3333***3333**333333**333***333**4444444444**566666*6666*77**757**7766**66*776*77****777777*77777663222*2*222*
222222**2*22**2222222*23*23**333333333*3**3333**33*333333*33**333*3334***434*44**4***556*6*666*77*7777*7*77776**67777777**7**777*77**7**6*6****2222222
2222222222222*222*2**22**333333333*3*33**3333*3**3333333****33*33333*3333*34*44*444444*5566666*677*7*7*7777***66*777*7777777777*55*6*7667**22*2222222*
22222222*2*2222222*22222232333*3*333*3*333333*33***3333*33333*3333333333333*44444*44444*56*5566*6777777*7777*66777777***7*7*77773*466*66*53*222*222222
22222*2*2222***222*22232*33233*333333*33333333*33333*3*3*3333*3*333**333*3334****4444445**5555*57*777777*77*66777*7***777**77*7*7*34543*33**222222*222
22*2****22*2222222*222*22*2******333*33*3*3333*3333*3**33333333***3333*333333*34*444*44455555*5566777***77777677777777777*7777*533*34*35*32*2222222222
222222*2*22*222**22222*232*23333333*3*3*33*33*333333*33*333**3*3333*333333*3*333*4*44444455*5***56*7*7777*77777*7777**777777**73*3*334*43****2*2222222
22*222*22**2*2*2222222**223*23*3333*3*33333333**33333333***3*3**3*3*3***33*333333344444444**55555**67*7777777777*777777*77777*7*3333333*2*2*222**22222
*22222222***222222*22223222*223*3*3333*33**3*333**333**3*3*3333333*3333*3*3333*3333444444*4*555556*6777*77777*7776*6777*77*777532*3*333*322*22*2222222
2*2*222**2222*222*2222**2223222**33333***33*333*333333333*333*33333**33*3333*33*333*444444*44*5555*66**66**777776666*6677*77**3*23332232***222**222222
2**222*2****2*22*22222*2222***3233333333333333333333333333*33333****3333*3*333**3**44444444445445*666665556*766666*6666776776*33322*3*2222*2222222**22
22222222222*2222***2*2322232***3333*3*33**3**33333*3*33333**33333**3333*33333*33*33433*33344*4444*466*445456566666*6*6666645222*22*22***2*22*2*222*2*2
2222*222*2*2*22*2*22*2222***2*2**3*3*33333**33333*33333*3333**33333*3*33****333333**3**3**3*34344445*44*44****55666*6*66633*2*2*222222**22222*22222222
*222*22222*2*22**2**22222232*3333*33**3333333333*3*3333333333333333333333333*3333**3*33333333*3**4445444*4455**56**6666664*22**22*2**22*2222*2*2*22222
222222222**2222222**22*23*3**333*33*333*3***33*3333*33333*33*33333*33*3**3333***3*33***333333*3334444444444444*5555*4*4**2*2*2222***2**22*2*22*22222*2
22222222222*222*23222233*3332*333*33**3**333333*3*3*333333*3333*333**3*3333**33333*****33333333*334444*4**4444***54444**2222222*22*22*22222**2*2222222
**222*222*2**222**2*222232*23**3*333*3*333333333*33*333*3*33**3333**333333333***33*333333333333*44*4444*34**4*4455***322*222**2222**2222***22*22222222
3222222*22222****322332233*333*3322**3*33333*333333333333*33333333*3*3*33*3333*3333*3333333333**333*443*33444445**43422*22222**22222222222**2222*22222
3222222222222*2*22322332223*23**3*3*33*3333*33*33333*3333333*3*33**3333*33**33*3333333*3333*3333*334333*333*44**544*422***22222222*2222222*2*222222222
32*222*22**22*2222322223222222*22322*333***3**33*3**333333333333*3333333**3333333333333333*33*3*33333**3333*44433*4432*2222222222*222222222*222222222*
3*32*222*22222*2222223222*222**332*223*3*33333333333333333***33333333333333*33*3**3*333*3333*33333***33333*344433342*2*2*2*22**2222***222222**22222222
3332*22222222222*22*222*2222***222*3*23333333*3333*33*333*3*3*33*333*3**333*333*3*33333333333***33*333333333*44222222**2*22*22*2*2222*222**22*22222**3
333*22*2*2222222*2*22*22222222222233*3**333*333333333333*3*33*3***3333*3333*33*33*33333333*33333333333333*3333222*2***222222222222*22*22222*22222*2*32
33*2*3*233323*2222*22*32*22*2*23*222*333333333*33333*3333333*3333*3*3333333333*33333333*333*33*3*3*33333333333322222222*22*2*222222*2*2233*22*222*22*2
3***2*322333*33*22*3*3*22222***2*33333332*333*3***33**3*33333333333333*333*3*33*3*333*3333333*3**3333*3**333*22222222***22***222*222*2*23*33322*22*2*2
333333*3*33333*2**33333*2*332323333**3*3*333333*3333*33333333*3333*333333*3*33**33*333*3*33333***3*33*3***33**2*2****222222222*22*222232*3323**22***22
333333*3333***333*3***33*2*33*33333333333333*33333*33*333*333333333*33*3333*3*3333333*33*333333333****3333*3222222*2*222*22222222**2*2*2*22*22*22*2***
3333333*333333*3*33333*33*33333**33**333333**333333333*3333*3333333333333333333*33333333**333*333*333*3333*3222**2**22*22222**22*2*22*222222*2222*2222
33333*333333**33*33*3*3*3*33333*333*33333*3*33333*3*333*3*33333*3*333**3333*3*33333****33*333333333**333*332222*2*2222*2****2*2*22*2*22*2222*2222*2*22
**33*33*33*3333333*3333*3333*33**3*33333333*333333*33*3*3*3**33*33333333**3**33*3*33333*333*33333*3333*2*322*22*2*2**2**2****222**2*2*2*22222222*2*222
33*3*333333*33***3*33**3***333333**33333333333**3*33333333**33*33*333*33*3333*33*3**3*333333*333333*33*2322222**22*22*22222222*2*2*2**22222*22*222*222
*333333333333**33*33**333333**333*33333*3*333*333*33*3333*3*333*333*333****333*3**333333*333**3333333*3**22222****22*222*22222**2*2222222**22*2*2**222
33*333*333*3*333333333*33333*333*333*3333*33*3*33*33333*33333**3333***333*33***33*33*3333*3*33**33*33333*22222**2*222222222*22222*222222**22*222222222
333333*3*33333*3333333*33**333*333*33**3333*3*3333*3**33333333333333*3**3*3*33*33333*33*3*333**3*33**332*2222*22222*222*222222*2222**2*222*222*2222222
*33333333333*33333*333**3333**3*3*33*33*333**3333*3*333*33*3333*33**333*33*33333*33333333333*3333*33*322222*22*22**2222*2**2*2*2**2*222**2**222222222*
*3333333*3333*33333333***33333***3333***3333*3333*3333**33*3333****3***3**333*333*3*3**3*3*3333333*33***2222****2222*222*2*222*2*2*22222*2222222222222
3*333333*3***33***3333333**3333333**33*33333*333***33333*333333333*333*3*333333*3*33*3**3**3333333333*22*22**2*22222*2**2222**22**2*22**22222**2222*22
33333*333*3333333*3*3*333333333333*33*33333*333**333**333**333*33333*3*3333333333**3**3*33333*333333*2***22222*222**222**22*2*2*22*2222222222*2*22*222
*3333*3333*3*333**3*3333**3333333*3*3333*333**3*33333***3**33333*3*33333333333333**33*****333**2222*2222*222222*2**22*22*22*2222222*2*2*22*2**222**222
33333333333**333*33***33*3333*3*3*3333333*3333*3**333**333*333333**333*3***33333*333**33*3***3*2*2**2222*222222*2222222222*22222*2222222222*2*22222*2*
*3**333333*3*33333**333***3333333333*3333*33333**33333*3*3**333*33*33333*33**33**33*3*3*3*3333*2**2222**2222222222*2*22*22*22222222****22222222*2**222
***3**333*3*3*3*33333333*33***33*333***3*3*3333333333*3333*3*333*333333*33*****333333333*333332222222*222222222*2**222222222***2222***222222*2*2222222
333*333*333*33333*333*333***3*33*33*3333333**3333333*33333333333333*3****333*333*33*3**33333332*2222222*22222*22*2222*22222222*2**2*22*22222*222222*22
3333333333**333333*333333**3333333*33333*3*3*3*33*33333333433*3*3**444*44*444*34444*4***44443322*22222****2222*22***22222*2222*2*22222222*222*222**2*2
44344*34443*4*333334**3*43333*43*33*4*3*443*4443**4443444444444**4444***44*444444444**44*44*432*2*2*2222222*2**222*222222**2**222222****222*****2*2*2*
444**444*444***4444444444**44***44444*444444**4444444*44444444*4444444444**444*44444*444444442222*222222222222222222222**2222222*2222*22*2**222*2*2222
4*444*4444*44**444444*444444**4*44*44444444444*44444*444*44**4*4444*4444*44444*44*44*4444**4222**222*2222222222*222**22**22222*2*2222**2*2222222*22222
444444**44*4*444***4444444*444444*444444*44444*444**444*4*4***4*44*44*4444*444***44444**4*32222*2*222*222**22*22*22*222**2222222222*22*222**22*222*2**
***44*4*444*44**4*4*444444444**44*4*4444**4**444*444444*444*44***4444*44*4444*4444*444**33*2*22*2222222222*2*222*22222222**2222*22*222332222*222**2222
55555555*5*544*45555555*5*45*4*45**5**55*55*5*555*55*5*5*55**555555555*555***66**666667*2**22*22222**2222*222222222**222222222222*2*22*222*222*22222*2
44*4**4*4**4*44***44444444**544545***5555*555*5*5555*5*555*55556**666**66666666**67332**222222*2**2222222*222222*2*22*2*2***22*222**223*2**2222*222222
4444*44*4*444444*4**444444*4*4*44**444**4**45555*5*55555555*55555666**6*666666*66*22*22222222*2*222*22*2222*22222*2*2*222*2222**2222*222222**2**22222*
444*4**4444444444444444444*4444444444*4**4444544555*555*5555*5555556666*666****6****22*22*22**222222*2***222222*2*2*222*2*222222222222222*22***2*22222
4*44*44*444*4444**44*444*44*4**4*444444*444*44**55455*555555**5555*666*6666*66662****222*2222*222*22*****2**2***222**2**222*2*222222*22*222222*22**22*
*444**4444*4*4444444*4444444***444*444444*444444445*55555556666*66*66666*6666662222****22222****2*22222222222*2222222*222*2*22222*222222222*2**2*22222
*4*44444*4*44444*44*4*444444444444*44*444*44444*4*4454**5555*5*555*55*555555662*22*2222*22*22***2*22*2*2222222*22*22222*2*222*222*222*2*222***22222*2*
4444*4*444444444444*4*44**444***444**44444444*4*4444*444*555555555*5*5555*5*555*****2*2222*2222*222*222*2*2*2*2*2**22222*2**2*22*22**2*22222*2222*2222
44*444***444444444444***44*444*444444444444*44****44*444**5*555555*55555*55*5*5**43*33**3232223233*3333333*333333***33*3333*3****233332*22222*222*2222
*3*4**444434*4*444***44444*444444**44*4*4444*4***444***4**55*5555*5555*555555**54333443333323*22*22*2222222222222222*33**333333334*3*3*444455555****7*
4434**343*44*4*44*4444444444444444444**44*44444*4*444444545*55*5555*5555*5555444*44443*3**3****222*2222222***22*22*2222*22*2222*2222*222222222*2**2*23
4*444343*3344434**44444*44*4**44*44444444*4*4444444444444*5545*555*555555*444444*44*4444333332**2*2**2*2222*22*22222222**2222*222222222**22222**2*2*2*
**434*34*4444***444*44*4**4*4444*4444**4444**4**444*444444*544*555544*4*44444*44*4*44*44***33332*222**222222*2222*2222**22**222222*22222*22*2*22*22222
3*43333**443***4*3*44*4***4**44444*4444*44*4*444*44444444444444**4444*4444*444444444***44**4333333*3*3*322**22*222*222*2**22222*222*2*222*22222222**22
4*33*34*33*43*4*434**444*4444*4*444444**4444**444*4**44444444*4444*44**4**444*4*4444*444433333*3*322*322*2**222*222*2222*222*2*22*222222222**2*222*222
**33*4*4*3*3**333**4*3*33443*44*44444444**4*4*4***4**4*44444444*44444*4*44**4***44*444*4*333*3*3*3*33*2*2*222*222222*222232*22*2*22222*222222222222222
**333**33*3*3**43**34*44**4344*4*4***44444444*44*4*44*4*44***4*4444**4444444444444*4**444444**3*33333222**222222**2222222222*222222*2*22*22222*222*222
*333333*3*3*3*33333**333*4433*434**3444*444*4*4444444444*45555*555*555555555555*55*54*444**44*3*3*3322**222222222222**222222*222**3**3*3323222***22222
333*33*3*3333***33*3333333*343*433**3**44444***44*4***44**4*444333*333*3*44344**44444*444444*44*33**3*333**3222222222*2*222322222**22*22**22222*2***2*
333*3*3333***33*33333*333333333*43*333444444*44444444444**44*4433**333333*3434444444444*4444444333333333*33**2*222222**2222*22*2*2222222222222222**222
*33*3*333333333333*3333333*3*3********43444444*44**44444*443333333*3334*3*4*44*44444*44444*4**4*3333**333**3***2*2**22222*2*2222222*2222222***22*22222
3*333**333333*333333333**333333*3333333434334**4*4*4*4*4*333443333333333***4*44**4444*444**4*4*343333*3333***3222222222****22**22*222**2222222222*22**
*33*33333*33*333*3333333333*33333**33**33*43444444*4444*44**44**45**5*555555*555555*55*5555544**4444433333*3222222222**222*22*2222*22*2****2**2**22222
3**3*33**3333*3*333*3*3*333**3*33334*3333*433***3444****344**34333*3333334*4*44444444**44*444443*33333*3*33*2222222222222*2222*2222**2*2*2*2*2222*2222
3**33*33333333333333*33333333333*3*3*33*334433**44*44444*4*4*4343434434444444*4**4*4*4*4*444444*444*33333*3*22*32**2**2*2222222**2222**2*****222222*2*
33**34**4444*3**333*3333333*3333333333*4*44444444444*4444444*44*4444***44444**44*4*4**44*44*444*44*4*433*3333****22*2222222*222222*233***3*33333333*33
*3*2*2222*3454333333**33*33*3333333333*3443334444444*444*44*4**444*44*4*4444444**444*44*5*455**44**3*3332333*322**222**2222**2*22**222*2***222*2*22222
323*222**222*43333**3*33*333333333333333*4*4*44443*444444*44*4444444**44444**4444*454555*5*5**3444*333333**3***3*22222222222222*2***2*2222*22*2*222222
222222222*222**2333334*333**33*333*3333*44334**3**4*44*4444444444444444*444444*45*55555555*55*5555444*33*33323*22333322**22*2***22222****2*222222**222
222222*2222222223*3*335333*333333333***333*4*4444*444*444*4*44*4444**4444444**5**55*55**55**6666666*64*44*444444**4445*56*6*2222*22222*2***22222222222
*222222*222**222233333*5**33**3333**3333*33*4444*4**44***4***4444555555555566*7677*66667*77777666*6654*4*3333**33333333333222*2*22*222**3***3333*3*333
*2*2222*2*22*2222*23*3*36*33***33*33*33*3**3*44*44*44444***4*4*44444*44*55*5*5*55*5555555*5556656*6**5444*4*33333*33*33333*332*22222222*2*2222222222*2
2*222*2*222**2222**23333444533*33*333333*344*44**444*444*444444***4*5**555555*5555555*5*656566666*6*6*6665*4*33*33*3*3333333**33222*2222*22222*333*33*
*22*2222******22*222223*34*35*33333333**334*44*444444444*4**44444**4455*5*5*55555*5****556*66666*6***66665**3*3*33*3*333333333333**2*22**233*2222*22**
**222222222*22***2**2*22**33***3**3333**34*4**4*4*44*4*4*44444444*55**555555*555*5556**566666*6**6666*665*54333*33333333**333333*3322*2*2*33322222222*
2222222**2222*2222*222**223*33*333333*333344*44*444***444**4**4*45*555**5**5*5555**6*6*66666*6*6666*6*66666555*544433*33*33333*33**33**22*2*22*2*2**22
22*22*22222222222222*2223*23*3*53*3333334444434444*4*44*44***4*455455555**5**55*6*566666**66*666666666**66***66*666666**554*4*333332222**2*2222222222*
2*22**22222222222**2*222*22233*333333*4*44**5*555**5*5*556*6666***666666*55*55555566666*66*66**66666*66**66666666**666*6*6555566666**6**54*44**334**5*
22*22**222*2222**2222222*22*33*3**3*4445**4555555**5*555*666*666*6*666*65555**66*6*6*6**666*6*66*7*777*776666*6665554*43*33*33*3*333*3332222322*222*22
2*2*22222222222222222**22*223*33*5**3433444*44*4**5*55*444444544*44*5***5**55*55666666*66***6*6*77**77*****666*6**6**554***3333**333333333**2222***222
2222222222222*2*2222*2*2222*22*3*3*5*3**4**4444***4444*44*444*5555*55*55555**55566*6**6*666**666*66*6*6**666666666**6***55*53**3*3***3333**333333*5566
2222222*22*2***22**222**22*2223*333*433333*43*444**444*4444444545*5555*5555**565***6**666*66*66666666677777**76666666**65555**3*333*33*3*3333**33*333*
2222***2*2222222**2222*2222*222*2*3334*4444*445*55555555*44**44***555*55*5*5555*55**666666*666*666666**766*66666*66**666*5**55*43*3*3*3**3333333***33*
*22**2*2*22222***222222222*2*2222**443**444444**44*555*5555*66*666666**66*6***77**7*777777*777**77888*8888*88777*7*6666*555555433*33333333333333333333
22*22*2222222*222222222222222222*2433**333**444**44444*55555555*6**66*6*66*7*66*777*77777777*7*88*88*8888*8888*88*877*7**7*7*64*333**333333*33**333333
*22*2*2222*222*22222*22*522222**2223333*3333*334**4*4*44444*4*44444*44*444445555555555555556*6666*66*6**666*666666*555*55*5*55*55***33**3333333333*3*3
22222*22*22*2*222*2**2222442*22**2**3334433343334344444*444444****5**444455*6**666******55555*55*666*****6*66**6666*5*5*555***55*543*3*3333333*3333333
*222222*2222222*22*2222*2224**22*22*333*3*3333*334**4444444*4*44*555*55566**55*5555555*55*5556*5*66****66655*66656555555*55*5555**444*4*3333**3333*333
22222*2*222222222***22*2222252222222233***3333*334****4**444***4444*4444*445*55*55555*55**5**555*5*5*5*6*65556*6**5555*55555*55*5*55*55***5*555*4*4*33
22*2**2*2*22*2*22*2*233***22232222222233333*3333**43*4*444*44*444444**4*44**4*5555555555555*555*555555555**55****56*666*666*55555*5554**3*34444444*333
22*222*22222*2***2*33333222*24222*22*2233343333333343*4**4*44444*4*44444**4*44454*5*5*5555555555**555555*6*66*666*66***5**5*5*5*5**44*555*5*55554545**
2**222*222*22****22***333*22*22222*222*3*3*433*3*343333*44*44*44*4*4*4*4444*44444*455*55**5555555*55*5555555555*555555*555555*5*55*555*5554*4*43*33**3
*22*222222**22222222*3322*2*2232**2222223333444*444*4**5555*555*55*55554*44444*44***4*454*4*5*5**5**5*555555555*5545*454545444444*4*44*44**43333333333
2222*2*22222**2*22222222*222*22422**2334444444*444444*445*5545555555*555554*44444**4*44**44*454455555*55**45555*454545**444*4*44*444444334*3*3333333*3
**222*222*2**22**22*2222222*2*3342333333*3**33*3333344*4444*55544*444*444*44444*444*444**4*444*44*444*44444444444444*4444*4444***444*4*443*33333**33**
***22***2222**2**22222222*2**22*2333333*3*333*33****3333*33*33333*44444444*44***444444**4*4*4*4*444*44444*44**4*44*4**44*44444*44444444444*333*333*333
2*22222222****2***222222**222222233333***3*333*333333*33333333333*4444444*444444**44***44444*4444444*44*44444*44444*444444**444*44444444343***33*333*3
*2*2**222**2***2*222*222222222*2*2***3333**3*33333333*333*333*3*343334334**444444444*44***44*4*444*444*444*4***44**444*44*444***44*44565565*5****555*5
2222222*2**22222222222*2*22*2*2**2**3**3*333*333*3333**3333333**3*3***3*4*4444444444*44*4**4***4*4**44***4*44*444**55556666666*6**6666*555**5*65555555
2*22*2222222222*22222*2***2222222*2*333333333333333333*3**33333*33*3333*4**3344***4444444444*444444***44*4444**44*44444*4*444*4*44444**444*555*565*5*5
222*22***22*2*2*22**22222**2*222*2**23433*3333*333*3333*3333333*3333*33333*4343343444*4444*44*4**4444444**444444444444444444444*4444*444444444*3433*33
222*22*22222*2*222222***22**2**222222233333333333333*33*3*33333333**3*33333*33*3*3*33434*44444***444*4444*444*44**4*44*4444*44*44*44*44444*444443*3333
**222222222222**22*2*2*22222**22222*2223333*3*333333*33333*333333*3333*3333*333**333*333*33*344444*444*444444*4444*44*444444*4*444*4***44*34*3433***33
**2*2222*2*22*22222222*2**22222*2***23353333*33333333333**3333*3333333*333333*33*****3*33*33*3*43444*4***444444**4444444**4*4*44444*44**4334333333**33
222222222222222**22222222*22222*2*2222*343*3333*3*3*33*33*3*333***3*33*3333333333*33333**3**3***33333*33*3**4*4*3*44343*43444*3*3433**33*33**3***333*3
2222*2*222*222**2*222*2**2*2*22222**22225333333*3**3*333333*3334*44333*3**33333333333*333*3**3*3*33**434*34*334444444***33***3****33**3333333*333333**
2222222*2222222**2222*2222*22222*222222**43*3333333*33**333*33**44*44*34***4444**333***3*3333333*33333*3*333334334*45555*4555*5**33334***44*444**44444
22*222*22*222222*2*222222**2*2222222222****3*333333*333*33*33333*333*3333*3333*34*44*444*4*445*444**455*5554*5445444*554*55*555555555*444*3*3333**3*33
*222*22222***22*22*2222222*222222*2*22*233333*3*3*333**333333334**444*444444444444*44444444*44444444333333**3*3*3*33333*33333333*334444*44544**444**33
2*22222*222*22222222*22*22222*22*222222322*333*3333*3*333333*33*33*333333333333333333333*3*333333333*33333*33*3*3*333**3*3***3**333*3*3334**44**3*3*3*
*22*2*2222222222222**222222*2**22**22*22**2*333*33**3*33333333**3333*333*3*33333333333*33333333*33****3*3333333333333333*3*3***33*3333*33333**33*33333
2*2222*2***2****22*2222*2**22222222222***2233*333333*3344*3*333333*34*44***3333*3333*3*3*333*33333***33*33*33*3*33**33*33333333*333*33*33**3*3**3333*3
22*222222*22****222*22**222222****2***22*32*4*33333333*3*333*33**322*333**43333**33333*3333*3*33*3*333*3*333*33*3333333**33333*3333*333333*33333333333
2*22*22*222**222*222***222222222222222222**2*33*3*33333*3*3*33*2222*2*3333343*333**3**3**33*33333*33333****33**333*3*333*3333**333*3333*3333**33333*3*
*222222***22*2222*2222*22222*222*222**22222223**3*33**223*3*32222*2*22**2**2*4**33*3333*3333**3*3*33333333*333**3333333*33*333333333*3*3*3***3*33*333*
222222****22222*2222*22222*2*2*222222*22222224*3*33322*2*222*2*22*2**2*2222*2223*3*33*3333*3*33***3*3333*33**33333****3333333333333333*3*333*3333*333*
22*22*2**22222*2***2222222**222222*2222**2*22*33332222*2*2222222*2222*22222222223333**3333333*3333**33333*33333333*3333333*33*333*3*33333333*3*3**334*
22222**222222*22222*22222****2222*222*222222222**22*2***22222*222222*2222222*22223*3*33333333*33*33333*333**33**33333***3***3**33*3333**3333333*3333*2
*222222222*222222*22***222**2**2222*222*22*2*2322222222222*22222**22*2222222*22222*33333333*33***3*3***3333*33*33*333*4**4****44444*4*444**43*333**3**
22**222*2222222*2**222*22222*222**2**2222222222*22222222222*222*222222*2*22*2***2233*3*3333*3*3333*3333*33333*3333333333*33344**444444*4*4*33*3333322*
2*22*22*222*22222**2*222223*22*22*2*22222*222222*2222222222**2222*22222222222222*2333*3**3333333333*33*33**3333*333**3********33333333*3*333*32333***2
2222222222**222*22*2222*222232*22*2*2*222*22**22*2222*2*22*2*2*22222*2222***22*222*2223*333*333333**333*3333*3*3*33**3*333334**44*44444444*3333*3222*2
2*22*22*2*22222*2222*222222222222*2222**2*2*22***22*22222*2222*2222*222*2**222*222*22222*3333333*33****3*333*33333*33**3444*34**33*43*444444**442*2*22
22*2*22*2**22**2**222**2*2*22222**22**222**22*2222***2**22222*22*22222*2222*22*2*22*22222*3*3*333**3333***3*3333*4443*3*33*3*323*3*4444344*44*32222222
***2*2222**22**222**2*2*2222*2*222*22222**222222**22222*222*222*22*2222*22222*2222***222*2**3*3333333333333*3*3**3333333333333333333***333*33*222*2*22
**222*2*222*2222222222*2*22*2222222222222222*2222***2**2*2**22*22222*2*2222**22*22222222222222*24233333***3333**333*3*33333333*3*3*3333**33*3*222*2222
*22222*2*22*2*2**22222*22**22******2222222******22222222**22**2**222222222222*2*2222222*222222222233333*333333***3333*3**3*333333**33333**2222222222**
*2222***2*2*2*2**222*2222*2*2*222222222*2222*22*2*2*22222*22222222222*2****222222*222222**2*2222*22*433*33333333******333333**333333*33222222222*2*2**
*22222222*222*222****222*22**222*22*2**2222*222222222*22****22*222*22*22*2***22*2222**222222222*2222*24*333*33**333233*33333333*333333222*2***2**22*22
2*22222222222*2222**2***222222*2*22**2222***2222*22*222222*2*222222****2*22***22*222*22*22222*222222222*42*3333*3**3332*323*3*3333*32222*22****22*2222
