4444444444*4*5566666666666*5666**5522222332334333333333**5*55666676667*76*6
44**44444444*54*666666665*555665555222*222234*333433333555*55766667*7*66766
4*4*44*444445*566***66666666666*554*223333334*3333333*3455555*666676766**77
344*434444*4365*66*666*666556665565223333333334333433*345555575666777666677
454444433334455566*66666*666**6*5*52223333***443334333335*555655667*7666777
4**4*4333333*45*476**666**5666665**3222233333*33334333*35555555456*876*6777
544444*333344465566*66*6666656*65555222222322333334333335*55564**56*7667777
345443333333345*5566666*66*6666655*422*2222*224*3343*3334555*65*55777767777
*544*333333334465566666666666*6*656*233333332233*34*333345555*4*558788767**
434*4433*3333**55556*6666*66*6666555*23333*3333433433333455556*44*7777787**
54*54433*3*333445555*666666656*6665553333333333343333333355556*548777778877
34344433333333*4655566676666*6*6655552233*33*3334343*33335555*65*777777*787
3345544333333*34365565**7666666666555223*33333333433*33*345*566*777*7777*7*
33544443*3333333466*55**4*6*666666566322333332*333*3333335*5566677777*777**
3335*5433*333333356*555*555566666*5656*323333323*34433*334555666*7766*77777
43335*44433*3333346555555555566666665523333333333343443*34555666*7666666*77
4443355443333333346555*5555555566665*522*3333*3*3233433334555657776**666777
*44*3354443333333366*5*5**5*565566*56633*2**333333233433*4555657*7*66656677
*44444454*4*33333*46*565555666666655655*2*3222222**234433355566777*66*65*77
444*54445443333333366*6555666666665555*2232*2333222*2**333555*6777766655*67
44444444544433333*44666665**666666665563*22**33333222344335556*777766665667
4444444444444*44**444666666*6666666656552222*333333232343*455667777*7766777
4444444*44444444444446*6666*6**6*66655552*223333333323243345556777776666676
44444444444*4*4444444*666666666*6*66665**222*33333**32*4434*56677777666*766
444434344344*5444*44*4*76**66666666666666222*333*3333332*3*5566777766666*65
44444*44*4444454444*44466666666666666665522*33*22333*333*4455667777**6666*6
4*4444*444*444444*4444*46666666*666666665222333333*33333*444566677666666666
4444**34444444*44444444456*6*66*666666666522322323323333*334556666666666655
4*44*434444444*444444*44466666666*6*66666622222*33**233*334455666666*6665*5
44443444*44444444444444444666*66*666666*5512222*2*33323332*355666*566665555
4344*44444444444444444*44*46766666666*6656**222*33333333*334456666*666*5555
444**44444444**4443*4444*44*7666666**666666112*3*2222333333445*5*6*667*54*6
44*44444444*4*4444444*444444*766*66*66666653122*222222*3332545556656674*5*6
444444444***44*4*4*44444*4454576*667*6*666561*222222222*33334*56*6*6*644*6*
44444*44444444444**4*4444555**577667666666561222222*22233*22**5665*6665**56
4444444*444*4*4*44*445445*4*45*5776*6*666666*2222*222*2232224455655*6655566
**444444444444444444444444444455*6**77766665511*222222222332345555666655676
45444444444444444444444444444455555777777655541*222*222*2333254556666*65666
445*4444*4444*44*44*44*4444444*555554555555*5611222**222*23333***6656655766
4545444444444444**444*4*4**4444*5*55*55555*555411*2222222233334556556655*66
445445444*44444*444444444444*4*4*55*55555555556112**2222332433545555*656*66
3444544444*444444*44444*444*4444*555*5*55545*563222*2222223*3334*55565576*7
333344554444444444444444*444444445555*555555*5*43122222*222333354*656646*67
443334*454445444*444*444444444**4455**55555556553122222*222**43*4455664*766
444***34455445444*44*44444444*445*46565*5555555*432222*22211*3*3*45**64*6**
5544444443445554*444*44444445444444*565**6**55554321222222111*3444*55655*76
555*54444*4445545*44445444454**444444466565*55556*42222*2211114*34455646767
45**5*554444**454*44445444*444444*5544455665555*5432222222221114344456*66**
3*33333345**54444454445444444444*454445444555544**5422222211111144445546466
3*333333333*55544**4*45544444*44444444554**444*4544322*22222111134444546*75
3*3333333333333355*44455544*4*44544*5*4555*445445544422222222221244445*6565
3*333333333**33333454*44*555444*544*4445544*4*55554544222222*222*2444566565
333333343*3333334333345*455*544*5555444455444*55554*4*3222**222221*444*55*5
333333334433344*444444*4444455555455*55545444545544444*3*22*222222244454455
333333344443444**4444444444*45**5555*5555544454454444444322*2222221*4445455
333333*444444*4455544444444*4*5565555555555445*55444333433332222*2213446*55
444444444455554445*44455*4444454*55555555*545555*4444*443333332222*22555**6
444444555554455554*3212*2*3455444*5555555555*55544444*44*3333*2222222*45546
45455555*445554*222222222*2*1124**45555*55*5*5*544445*4*3333*3222222225*646
55*55644555422222222*2222*2*22*22*34555**55555*44*4*443**3*33333232**215555
555*5*4555222*22232222222222222333*334455555545*445544444433333333*3222*565
655444553*22222**32222*2222222233*33334455*55444455444344443*3*33333**22564
5*44565332**333*2233332*32222233333444444*55544544444444433*4334*33*3322456
4445553322223332*2333323*332233334*4555*54555*5445444444*4444344333*3322256
4555543*333333*3*3333*3333332334444*453**332455**4444444444444*44333*333245
5565433*333333333*33*333333333*4455623333531112555*444**44444444344434333*6
555553333333*333**333333333**444555**33354111112*54444*444444*4444344443343
55663*33*3333333**344**333333*445533333451121111165*4444444444444444444**44
55*5333*33*3333333334*44*333454*5333**45*111*111115*44444444444444444444444
5**5333*3*3333333344*444433344556333334621211**11116544*4*444***44444444444
**5*3*333333*33*343444444434455633333456*1121111*11155444444444444444*44444
*65533***3333*333444444444445*543333*465*1222111*11135643445544444*44444444
5655333333*33333344445*4**445663*333446311222211111126654444444*4444*4444*4
5655333*333*33333*44454444455*43333444621122*22*111112555444444444444445444
56653*3333333*333*4444544455663333344561111*1221111111*55**4444444445445*44
