*12*14144314231
41144*242*24124
1*4242*143*4422
3443224*3*331*3
4312*33*2214*14
4142*24*3314333
13134*24344**1*
421124121341231
*34343124**2413
3411121112*3424
41214*414441431
*41323442433133
1341*1144*3*323
21212133444*142
44334412*322413
