1111111111
*11*111111
111111111*
1*111*1*11
1111111111
1111111111
1111111*11
1111111111
1*111111*1
111111*111
