55555555555555555544444444444443*2783664466554333343*647*55666354456345*4*6
55*55555555*5555544444444444444335246676477*33*433344644*554466555353**476*
5555555555*5555*54444444*44444427675*656656523*433*456*4455664*8*76*4566676
55*5555555555555444444*4444*336*67677667577673444544666545*6657**7*55*57566
55555555555555*5444444*4444*565*57333333436334*55*556665545*686657656456456
555555555555*5555444*44*4444444433444333333435*55*55545*35577*7867565555565
55555555*5555555554444*444*44444444333**4*3334565655656*787786667788*575*8*
*555555555555555*554*4444444444*4*4333*3*3245556*4*75688773*576**676*7*566*
*5555555555555555555*44444*44444***3262*34*66*6555*5577854764**854467888886
55555*5*5*5555*55555554*444444332**32555566455*566556677788656*757**86*7684
5555555**55555*5*55555544444456666332*5866454554*55465*46668*68746567*67*76
5555*555555*5555*555555544444377575555*635*5445*555456447677*5*567667*67876
5555555*55**55*55555*555*44443777*6675676*665*43*85566766567*7***768*544*77
*55*55555555555555555555*5544*3346765455*5*444445454445568758*667376756788*
**5555*555555555**5555555555*44*3455555**755545466455*7*6867868367564646575
555*5*555555555**555555555*54*444*355455**646645656**66678468468667*6****88
555555*555555*5*55*555*555*554*44*4**565*54666*66555*5578547666666*689*7878
*5555555*5*55555555*5555555555444444446**55734**76*66556766776666687767766*
555555*555*5555***5*555555555544443465*65*554555776865766656676668785678688
55555555555555*555*5*55*555555*444434536554566*657566467667646775*668668778
***55555**55555*5**5*555*5555555*4*34*45*55575575*68566247**7*866678*768788
55*55555555*5555555*5555555*555544433*565678**5**4745765755*8**8*66*786887*
5*55555555*55*5555**5*55*5*555555443*44767785864*7864857387877786887**7556*
55555*5555555555555555555**55555*5445476867786568**54678548*85667*78555533*
555*5555*555*55554555555555**5555543666*677556688486866767*7555666**35*3336
*55555*55555555636*734555***5555554**7666856*76*54747867683*744453544433446
555555555*5555667*7688**445555555546*66*556*64*688836*785**36476*5*44543433
55555555*5555*47668776*666*455555546**656***54*68753576678568*87776654**443
55**555555555*367*8786767*675657434666546**63*67758**76*5*7855537*87864*3*4
55555*55555555*764*856688765676*7677*67567565576*43766*67775555546555766423
5555555*55*55557848667547*675576776887*87*46764543444667*55*555545564687572
55*55555**55556*57866*8*355656746477768**745782444*4*565*55555*5**6*55*6645
555*55555555544*574856473743*5745*36676*777875345555555*555555544*553**678*
5*55*555555554457455*4448*644546*47676**4768884*555555555555555*5*45*4476*4
55**555**555537*774544*53*4*5453*7566367848**745*55**5555*5566*4*55544866*8
5555*55555554467**4*44*2433*8648846647343*86*5555*55555555555784*555577*755
5555555555553666*5538434646*76655666*5*376*535*5**5555555555588555555*336*7
5*5555555554*76*6*8**7*6**83*3*458747**5644555555555555*55*55475555555544*6
*55555555546656346***43573*4353*563678644*5555555555*555555*54**55*555**544
5*555*5****5*56*554456**53435*5488875*24555*555*555*5*555555478*555555555*5
5*5555*55573444*56*4*767*5*34547*6566245555**55555*55*5555565575555555555*5
*5555555555*544*74*74*4**64434*5448744*55*5555555555*555*5*448655555*5**555
5555*5555*545*66*44644754333*3**5495455555558445655555555555*658*55555555*5
**5555555553634545548344*755544328744555*55*43555555555555543466555555*5555
*555555555455556*8766665756**4*7558635556*555*55555555555554845**555*555*55
**5555555544556*68*78558*53866666677*5555555555555555*555*5*68455*5555*5555
55555555555468856*53445323436*7568**555*5*5*55555555*55*5555555**5555555555
555555555555544*45*333454*72457****5555555555555555*55*5*5*55*5555555555555
*5555*555555555443334**6738347666455*555555**555**5555555555*55*5555*5*5555
**55*55*555****5445*77585575876**5555*55555555555**5**555555555555*5*554556
55*55555*5555555*46974444436635555*55*5**55555555555*5555555555554*555446*7
55555555555555555*4655555555*5555555555555555555555555*555*55444344454**444
5*555*5555555*55*44855*555*555555555*5*55*556*55*55555*55*5443*574454554*55
555555555555*5554**44**5555555555*55535745424766444*65635344556843**45*5555
555555****5*555544554455555555555*5*4625*43*5*34455*62476668535*46844555555
555*55555555*55444657447444455547372*4**56622*876734648645583546*8344455555
555*5555**55*54444557654532**2*33**866*6546233544*335*2*1*4262745*2344*5*5*
555*555*5**444344345577558*9843*43556545524328323344*363***6467732*33444455
555555*5*4443443457645654223475649636245*6456852*5477858589629*1414333344*5
5555555344*346544433*4*21*434515475443*32**4154*43324758482545227*433334444
555*55444343*34665*58*79388222444533233364267277842333344545*5*735443334444
55555443346544258*7*6481133413432*1321465657*583*4*3422237242294433*3344444
5*5*423**45565*6648755*24442223329***33746*761*355*5*22233***5*6543333**4*4
55*4454523*333*55*624*234411422**12*478*4*23332**3*532222*222*1*52343344*44
55433*321*43*456*56664565326*26317*5483535445554446532222*22214123334*33**4
5*4443324334554538473444345324637797423*44415*634323*22*2222**123833*333444
554*48*557764775474*3*24*635478545343454*33*55*54*42*2222222*122*342222*334
*544*667*88676435**4324552256684*443***43*4555*3*342**22*22*222113623222***
*55322**46573686*5454445753712*323335**2*3*54534322*23322222211*45*33321322
*42432354733766635127234631152433444322333*4653435333222*2222224233*22*1356
34145*4*585637854*5655345622243*44434233**3*443352132*2*2222222322234*14365
45555777682486*863642*4344224*33333*42333*43343433222122222*22224315*533434
325*6*45546242233*3**4*4*42*433**3333**3*35433543422*3232222222213534233126
5*7*474332523343*6*3*32752333332433333333**3333**2222222*22222***2532333236
3333*44522327333335*3*426*533333*333333322343342222222222*22222222432222333
