222*22222*2222*2*2*22222*22222222**2**222222222*2222*22*2222*2*222*2222222*2*22222222222222*2222222222**2**2*222**2222*222222*222*2**2222*22*22*22*222
*2*22222**2222222*2222222*22**22*2222*2**22222222222222**2***2222222222*2*2*222222222222*2222222222*222222222*222*222*222**22**22**222222*2*2*22**2222
2*2**2**2*2**22222*2*22*2222222*222**2***222**222*22*2222*2**2**222**222222222*2*2*22*22*22*2*22*2222*22**22222*22*22*2*222*2*222222*22*22*2*222222**2
**2*2*22*2**2***2*2*2*2222222222*22222*2*222222222222*2*2*2***222*2***2**2222222*22*2222222**22222222222**22*222*222**222222*2**22*22*2**2*2*2**222222
2222*2222222222*2*2*22222222*22*22222222*2222*222222*22222**222222222**2222**2**2*22222222**2*222*2**22*2222*222222*22*2*2222***22*2*2222*222222***222
222222*2*2222***2*2222222222*2**222**2*222*222***2222*2*222*2*22*22222222222222*222222222**222222*2222222***2*2*222222222*2*2*2*222*2*22*222222**22222
2222*222222*22222*222222*222**2222222**222*2*2*22*2**22*222222222222*2222*2*222222**222****2*222222*2*22*22**2**2222*22222222**222*22**222*22*22222222
22**2222*22*2*222*22**2222*2222*22222**222*222*2222222222**22222222*2222222*222222222*22**222222*222222*2**22222222222*222222*2****2*2222**2*22222*222
*22*222*222222***2*22*2222*22**2*22222222222*2*222**2222222*2*2*2222222222*2222222222222222*22222222222*2*22*2222**222222*2*2222*222222222*2222*2**2*2
222*222*2222222*222***222*222222**22*2*2*22**2*22**2*22222222***2222222*2222222*222*2**222*22*2222222*222***222222**2***22222*22*2*22*2*2**22**2222222
2222****22**2*22222*22222**222*22*22222222*2*222***22*222222*2222***2*2222222222*22**22*2222222*2222*2***2222222222*2222222**22222*222*2*22*****22222*
2*222222*2*2**222222*22222222**2*22*222222*22***222222222*2222***2*2**222*2222222222*2**22**222*2*22222222222*22**2*2**222*22222*222222**222222222222*
2*222222*22**2222*222*22*2**2**222222***222**22*2222222*22222*222*2222**2*222*222**22*2**22222*2222222*2222**2222222222222*22*222****2*222**2***2*2222
**2*222***2*22222*22*2*222*222*222*2*2*222***22222*2222*2*2*222222222**222222222222222222*222222*22*22*2*2*2*22**222*22222*222*2*222222*222222*2*2222*
22**22**222222222222222222*2*22*22*2**222*222222**22222222222222*222222*2222222222**2*2*22*222*2*2*2222*22**22222*22*22*2222222222222**222*22222*2*222
22222222***22*22*222222222**22*222*2*22222222*2*22****222*2*2222222*22*2222**222222*22*222**2*2*22*2*22222222222*2**2222222*2222*2**222*22*222**22*222
2**2222**2***222***22222*2*22*222*2*2222*22*2222*2222222*2*2*2222*2*2*22222222*222222222222222222***2222*2*2*22222222**22*22**22*22*2*22*22**2222222*2
2222*222222222222*2***2222222*****22222*222**222*2*2*222222*22*222222222**22***222*222222****22**222*22*2*222*2222222*2222*22222**22222222222***22***2
222222***222222*2*2**2*2222***2**2222222*22222***22222**2***2222222*222222222****222*222*222*2222*2*22222**2222*222*22222*22222222*222222*22**22*22**2
*2222*2**22**22222**2*2**22*2222222222222*22*2*222222*22222*2*222222222*2*2222222*2*2***222*2222**222*2222222222**222*222222***222222*22*222222*222**2
22*22222222*2222*222*222222**22222**222222*2**22**2222***222****2*2222222*22222***2222**222*2222**222***222222*222222222*2*222222*222*2*2222222*2*2222
2*2222*22222*222****22*222**2*222*2*22222222*2222**2***222*22222222222*222222*2222222222*2*222222*22*2222*22**22*2222222*22222**22*22**222222*22*22222
22*222**2*2*2*222222**222*222222222*2222*2*2*22222222222222222**2**222222*****2**2222222*2222**2*2222222*22*2222*2222222222**22**2222**22*222222222*2*
222*222***222*222**222222*222**22*2*222*2222222*2*2222222*222222222222**222*22*2*22*2222222*222*2*22222**2**2222222*2222**22**222222222222**22*2*2*2*2
22222**22222*22222*2*222*222*2222*22222*222*22222222*2*222*222*22222222222*2**2*22222*22222*2222222*222**2*22222**222*22*2***22*222222*222222222**2222
22222*2222*2222222*2*222*22*22222222*2222222***2*222***2*2222222*222*2**222*222*22222*322222*22*2222222*2*2*22222*22*222*22*22222*22*****222222222222*
22*2*2222*22222222222222*2222222**2*22222**22222222*222***222*222222**222*222222222222*222222*22222*222**2*2*222222*222222*2**22**22222***222**22**222
*222*2222222222*22*2**222222*22222222*22***2*22222222222222222222*222*22222222222*2**2*2*22**2222222*2*22222*22**22*2222222222*2222222*2222*22*222*222
*22**2*2*22222*222222*22222222222222222*22*222***2****2*2222222*22*222**22222*2*222*222*222*22*22222222222*2222222**2222****2*2**222222***222*2222222*
222*2222222****22*22*222*2*22*2222222222222222222*22222222**22*22*2*2222222*2222**2222222**2222*2222*22222*22**22222222*22*22*22****2222222222*22*2222
22***222*22222222**22222*22*222*2222*22222**2222***2*2*22*22**222*2222*22**22222222*22222*22**22*222*2**222*2258***22*2*2222**22*2*2*22*22***222222*22
222222*2*2222*2**2222222*22**22*222*222*22222*2*22222***22*2222*222*222222222**22222*2222222*2222222222*2***2**422*22*2*2*22*2*2***2*2*222*2*222222*22
2**222222***222*22*222222***2*222*222*2*2*222*22*22222*2*2*2**222***22222222**22**2222*52*22222*2222222*22*22**3222222*2*22*222222*2222*22**22*2*222**
222222*22*222222222*2222222*2*2*22*22***2*2222*2222222*2222*222*222**2222*22222222*2**2322*22*22222*22***2222*222*2222*22*2222222*222222222***22*222**
22222*2222*222*2222222222*22222**2*2224*2222*22*2**22**22*2222**2222*22222222*2222*2**2322222222*222**22*2*2222**2*22*2*22222*2*2*22*222**22222222*222
2*2**22222*222222222**22*222222*****222222222*2*2**22*2**222**2222*2**222*222*22222**222322*22222222222*2222*22***2***22222*222*2222222*222*2*2222**22
*2222*222**2*2*2*****2*22*2**2222***2*22*222*42**2222222**2*2*22222222*222*2*2222*2*222222333*2***22222*2*2*22222222222*2*2*22*22222222222*2*222*22***
2**22222***2222*222*2222*22*2*22**2*2**222222*2222***22222222*2**222*222*22*2222*22222*2*2224*22**22*2**2222222222222*22*2222*222**222**222**222222*22
222222*222222222222*22*222**22222222222222***222222**2222*222222*22222222222*223**22222*232322*222222*2222*2*2222*22222222222**2*222222222222*22222*22
2**2*2222*2222*22222*2**22*2222222222*2222*22222222*222**222*2**22*2222*222**22*22*22*22**2332**22222222*222*2**2222**22222**2*2*2222222*22222*22222**
22222222*222222222*222*2***22*2*2*2*222**2222*2*22222*222222*222222***2222222222222222222223333232*22222**2*2*2*222222222322**22222**22*222**2222***22
222222*2*2222222**222222222222222222*22*22**222*22222*222*222*222*222222*22***22*2222*2222*33***3**2222222*2*22*2222222*2*2**2222*222*2222*2222*22*223
***2**222*22222222222222222**2**22*2*222***22**22222*222222*2222222*2222*22**2**3*22***2222333***3222222222*2222***222*22222***2*22****222**2*2*22232*
*2*2*222222*222*222222222*22222222*22**2*2*22*2**222*22222*22*222*2*222*22*2***2222**22**22**33*33**22*222222*2*222**22222*2222222222**22*22*22223332*
2222222222222222*22*2*22222222**222*2222*2222*2*22222*222*222*22*222*222222*22*222*2222**22*33333333*222222**2*2*222222*22****222222222*222*222***3233
2***222*22*2222222*222*2*222*22*22**22*2*222*22222222*22222*22222**22222**22*22*222*222*2*2*3333333333*22*22*2222*222**2*2*22*22222222222*2222*333*33*
222222222222*2*2222*2*2*22222222222**222*222*2**2*2*2*2*22*2**22*222222222*22*2222*22*2*2222333*3333**2*222222222222222**222222222222*2*2*2****23*3333
22**222*22222222222222*22*222*22**222**22*22222222222222*2*22*22***22*22222222*222222*2222*3*3*333*33****22*22222222*222*222*2222*22222*2*22*323**33*3
2222222*222*222*222*222222222*2*222*22222222*22*2****22*2222222222***22*222*22**222*222*2**323333*333*32*2222*222*222*222222222*2*22***22*2*3333333333
222222222222222**22***2*2**2**2**2**2*22222*2222***22222*22*2*32*332**2**22222*2*2222*222**2**333333***322**222222***2**2***22*2222222222*23*3*3333334
2*2*222**22222*22222222222222*24*22*2**22**2222222222222**22*2*2364333*2222*2*2*2*2222*22*222*3*333*333*2*3222222222*22222**2*222222*2*2*2333*333333*4
22*22*222222222*2222***2222**22222*22**22*2222***2*22222*22*222*3*33*2*2*2222**222*222223*22*333*333333332*22222***2**22222222222**2222*22*33***333*4*
*22222**22222**22222***222222222*2222*22222*222*2222*2222*222222222*23***322222**222**3223222*2333*333***2222**2222222222*2**22222*22*2**2*3333***44*4
2222222*2*222222**22222222*22222*2222222222222**222222*22*2*22222*2*2232**2*2222*222*22222*222*33*333*33332*2222*2*222**2*22**2222222222*2333*333*4444
*2222222222222***2*22*22222222*2222*22222**22222*222*2*22*2**22*22**2222222*22222*2*2*2222*22222*3*333333**322*2**222222222222224*2222*22233333334444*
*222222222*22222**22222***22*22222*22*222222*2*22222**2*2*******2222**22***22222222**2*2*2*222332*3333**3**33222*22*2*2222*22222*22*22222**33333344445
2222222222*2*222222222222***2222222222222*222*2*2**2*22*2222222**222*2222*2322*223*22*22*2*2223***333**33333333*2*22*22222222*222*22*222*33333*3***445
2222**222222**222**2222222222*222**2*22222***2**22222****222222***2**2*22*222*2232222*22*2*2*22*22333333333333322***2*2**2*22*22**2*22*22333*33*4*4*55
222*2*2*222222222222*2222*222*222**2222222*2222***22222*2*2*222222222222***22223222*22222*22222*33*33333*3*3*32*32****2*22222**222222*2233333334444455
*222*222**22***2*22*2*2222*22***22*222*2*222*222*2*2222*2***2222*222222**22222222*2*2222*22*2223***2*33*343*33322322*2222222*22222222*2*33*333**4**456
22*2**22222**222**2**22*2*222*2**22222222*222*2**222222**2*22*22222***22****222*2**22222222*22233322***3*4*3*333332322222222*22222222*2223*3333*444*78
22**2*2*22*2*222222*2****2*222222222*22*222**2*22***2**2*2*2*22*2222222**2*2*222*2222*2**222*22**32*2333*3*44**3333**3*222222**22222*22*2**33*34*4*57*
*2*222***2*222222222222222222222**222*22*22222*2*22222**222222222*2*222**2222*2*22222***2*2*222*32*32*3*3*3333333323222232**2*22**2222*233333344444456
2*2**2**2222*2*****2*22222222222*22222**22222*2*2222**22*2222*2222*222***2**2222**2***2**22222*2222222*3333333*3*333*22222*222*22222*22*2*3333*4444555
2*2222**22*2222*2*2222222*22*22222222222*2222*222222*222*22222222*2222*2*2*222**2*2222222**22*2222*232*33333*333333323**222*2**222*2*22*23*3*33**44*5*
2222222222*2222222*22*22222222**2*222222*2222222222*2**2222222222*22****2*2*2*222222422*2*222*2222**2*333**333*3**33***222*2*222*2222*222333*3*4*444**
**2*2*222**2*22*2*222**222***222222*2*22*22222*22222**2222***2222*2***2222*222222*3222222222***22*222*2*33333*3**33*3***222222*2*2*22**233*33*34*44*45
*22*222***222*22**22222*22222*222222**222*22*222222222*222*2**22*22*222*22*222222*222222222*22222**2222**333**3333332*22222**2*22**2222**333*3344*4444
222*222222222*22*222222*22***2*2222**2*2222**22222*2*2*2222222*222**2222222222222*22**22*2*2*22*2222222333333333*33*3*32222**222**22*2**2233***444444*
22*2*222*2*2*2222*22**2*222***2*222*2*2*22*2**222**2222222*222*22222252*22222***22**2222222*2*222*2****23*3**33*3*3333*222**322222222**223*333*34*4444
2222222*222222**222222222222*22222**2*222222*222222*222*2*2*22**2222*22**2*2222*2222**2*2222*22*222222*2*3333*333*3*3322**22*2222*2*2*2**23333*3*4*444
22*22222222222222222222222222*2**22*22*2*22222222*22222222*22222222*222*2*2*22222*222*22222*22222222*222333*33*3*3333333*2**2222222**2222*23**33343**4
2222222222222**2**2222**222***2*222*2222***2**22222*233*3223322322232**2222222**22*2****222222222*222222**33**33**333333322222*2222*2222*22*3333333334
2*222222*222222222222*222**2*22*222*2*2***222***2*2333**3*3**33*333**3*2222222*222*22223222*22*22*2*222*323*333*3**3333*32*22222*222*222222*33*33*33*3
*2222*222*2222*22*22*22*2*22**2222*22222*2*2*22223*222*3333333*33*333*3222222222**222223*22**22*22*222222222333333***33332*222222*2*22222**2*333433*33
*2*2*22*****2*22222*2*222222*22**2*2222*22*2222*22223**33233*3*33*3333*3*2*2222*222222*22*2222*2**2**22222223*333333*33*3**22222222*22222222233**34333
2222*2*22222222222222*22*2222*22222*2*222***222223332*2333**33333*3333*3*2222222222222****2*2*222*22*22222222***3*33*33*332*23*2**2*22222222**33333**3
2222*2*2*2*222222222222222222*2**2222**22222*22**22*333**33333*33*333*3*222***2*2**22**222222*2222**2*222**222*3*3333333****22*222222*222**222333*333*
222*2*2*2*2222222*22*2*2*22222***22*2222222*2*2**22**33*333333*3*33*3333332*322*22222222*22*222*222222**22*2*2*222*23*3*3*2222*2*2222*22222*22233*3*2*
22*2*2222*222*2222222*2**2*22*222*22**22*2222******3223333**333*3*33***3*33222*22*2**22*2*2222***2**2***2222222222*33*3333*2*22222*222*22*2222**222333
2222222*222*2*2222*22*22*2222222*2*2222**22*2**2*2*332*33****333333**3333*33*3222*222*22*2222322222*222222223***22*223323323222222222**2222*22222*22*3
2*222222222*2*22222222222***222*22*222222*2*2*222*2*2222*3333333333*333*3*33*333322**222*2***222**222*22*2*22**2*22*2232333*2*2*222222222*2**2*2222*23
**22*22**22222222222222*2222*222**2*2222222*2*2*22*2222**22***3333*3*33**3*33***32*2*222*22**222*2222*2*2*2**222*23*2322*33*3**2**2*22222*222*2222*232
2**2*2*22*22*22*2222*2*22*2***2222222*22222*2222*2*2**22*2*2233*33333333*3*33*33332222***2*222222222*22*2***2**22222222*23222322222*222222222222222**2
**2222*2**222222*22222222*222*222*222*2222**2*222*222*2**2**2*3*33*33*3*333*3*3333232222222222222*2*2*222**222*22*2*2222*222*222222222222*222*2*2**233
22222222**222222*222**2222*222*2*22**222222*22222*2222*222222233*333*333333333*33*33**2*2*2*222222*22*2222*222**22*2*42*22*222*2****2*222*2222222**233
**22**22222**2222222**2*22*22222*222*2222*2*22**22*2222222***333****3333**33*3333*3*23*222*2222*222222222*22*222222*2*2**22*2222222*2222222*222*222***
*2*22*2222*22*22*2222222*22**2*222222222222*2222*2222*2*2**22333*33*3333**3*3*3*3*333*2222*22**22222*2**22*2222222*22*22*22**222222222*22222222*22*2*3
*2*2222**222222222*22*2*22*22**222*22*2**22*22222***2222222***333***333333333**33333**3222222222222*2*22222222**222*2*2**2****22222*22222222222*222***
2222222222222*222*2*22*2*22*222222222*22*2222*2222*22***22233**3333333*3333*3333333333**222*22*2222*2*222**22*2222*222222222***22**222*2*222*22222223*
2*22222222**2222*22**2*222**2222*2222**22*222222*222222*2*222*3*3*333333*33**3*3*333*33*33332*3*222*222*222*222*222*2*22222222*222*2**2222*2****222222
222**22*222***222*2**2222**222*22**2222222*222*222*2**2*22222223333333**3**3333***33**333*3333*2322222*22*2*22222*2222*222*22*2222222222*22*222*2*223*
22222*222*22*2***2*22*222**2*22*222*2222*2*2222**222222**2*223333*333****3333333333333*3333333*3332*2222*2222222*2*2222**3222**2222*2*2*22*22222*22***
222*2*2222****2***2222222*2222*2*222222*222*2*222*22222222222333*3*3333*33333*333*33*3**3**3333*333*22***222222*22222222*****222*222*22***222222222*33
2*2*22222*22*2***22*222*222*22*2222222*22222222222***22*2*22*2*3333*3333333**333**333333333*3333**3***3*222*3222*2*222*22**22**22*222222222222*22***32
22222**22*222*2222*222*2222*2*2222222*222***22222*222222*2*32233**333333*3333333333*3*3*3*333*333*33*3*332**23*2222*2*2222*222*222*22**2222222****22*3
222*2222222222*22222**2222*222**2*2*22222***2***22222222*22**23*3*333***33*33*33*333333333**33333*3333*323*222**2222*2*2222***2222222**222*222222**23*
2**2*2222222222*222*22222222222222***22*222*222**2***3*2222*3333*333**3333*33*3*3333**33333*3**3*33433*3332222*2*****22*2222222*2*3*2*222*2**2*2*2**33
*22222*2222**22*2**2222222*222222222*2*2****2*22**22**2*23233333333*33**333333*333*33**33*3*333*3**33333333*23*2**2*2222*22**22*23322*2222*22*22*22333
222222*2222**222**2**22222*2*2*222222*222*2222222**22**2*2*2*323333333333**3333***3333333*3**3333*8*3*3**3333*22222222**222*2***3*2****2222222*2222332
222**2*2222*2*222222222***2*222*22***222**2222*22222*2*22*22*222333**33*3*333**3*333333*3***3*4*44*4**3*33**2*3***2*222**2*22**2*22*22*222*222*2*2233*
***22222*22*22*22**222*2222222****2*2222222222*222222222*2**2**332*33333*33333333333*33**33**3*433*33***3*33*3333222*22*2222222*222222322222*222*223*4
22*2222222222222*2**222**2**2*22*22*22222222222**22222*2*22*22**2223*3333333*333333333**33*33*3*3*3*3*3*333333332**22222*222*22222***2*222*22222222*4*
2*22*2222*22222*222222*22222222*2222222*2222*2*22*2222*2*2**22*222*23*333333333***3*3****3*333*33*33333*3*3*3*333222**222*222222**322*2**2*22222222**4
2*222*222222222*22222*2222222222*2****2222**22**222*22222*22*2*222223233333333333*33*333333*44*3*33***33333333333*322222222222222*2**22232222*22222444
2222*22****22*2222222*222233*22*2222***2**2*22**2*2**22*222*2222222*33333**3*3333333333*3***44**34433*33*3**3333*333****22*2222***2222**2222222****44*
22*2222*22*22**2222***3*2223232223*22**222222322**3*2222222223*23*2*23*33*33*3*333333333333****344*44334*3*333*333*33**3222*22*22*223*2*33**33222*24*4
3333222*3**2322222*2222*3*33323*3323322333*3333*3*323*3*23*2*3233*223*33*33*333*33*3*33**333*4**4444*4*43333333*33433*3*23332*2*23**3*333333333*333444
33333*33333333*33**3332*233333*333333*3*3333*333*3*3**23***3***3*3*333**3333***33*33333*33*33*344444444434*3*3*3*33*333**33*3*333333*3*33333*33*3*3445
333*333333*33*333**3****3**3*333*33*3*3333*33*3333333*3333*33***33*3*33**3*33333333333**333333*44*44444**4*3333333333*3**3**3*33*333333***3***3333444*
3*3*3*33333333333***3333*3**33*333**33*3333*3*33**33*33*33****3333**333*333*3*3333333*33333333*34*444444444443333*333333******3*33333*3*33*33333*34*44
*333333333**333*3333***3**33***3*333333*3*33*3333*33333*33*3*3333333333*333*3333*3*33*3*33*3333*4444444*4444444333*3*3333333*33*333*3**333*333*3334444
*33*33*3*3*33333**33*333333*333*33333*3333333333333*3333*33*333333333**3333**33**33*3*33*3333*333444***5444444*443*333*33333***333*33*333*333333*3*444
33333***3333333333*3*3333*33333333333*33*3*333333*3*333*3*3*3333*3333*3**33*33**33*3**33*3*33333343*44*454*4*44*43333333*33*333333*3333333333**333*444
*333333333*3***33*33*3*333*33333333*33*3333333*33333***333333333333*3333*3*3*333*333333*33*3**3334**44*4*45*544444*343333*3333*33*333*3333333***33*4*4
3333**33*33**3*3333333*3333**333*33333***3*3*3**33333*3*3*3*33333333*333*3333**3*33*3333333333**3*3444444445*4444444*3333***33*333333*3***3**3*33*4*44
33*33333*3333**3*33333*3**33*3333333333333*333*333333333**333333*33****333*3**33*33*333*3***3**3334*444*4*5*5444*444*3333**3333333*333*333*33333***44*
**333**3**3*333*3*3**33*3*3*3*33333*3*33*3*3*3*4*333333333*333*33333*333333*3*333*3*33*3*333*3*3333344*44555*45444444*3*333*3333*33333*3333333333**4*4
***3**3*33333*333***3333**3*3333333333**33334444**3333333*33**333**333*3*3*333*3*3**33*33333**3*33343*4445*555554*4444*3333333333333333*3333*33*3*4444
***3333333*33*3333333333*3333*3333*333333*3*3*4****3*333*33*3333*33*333*33333*333333*333*33*3*33*3344*4*4**5**5*5*5444***33333*33*33333333333*33334444
*33333333*3*333*33333333*3*3*3*33333*3333333*444*44333333333333*33**33*3333333333333*33333*33*333***34*4445*5555555*44443*333*33*3333*333*333*3*3*44*5
333**3**33333*3*333*3**33333*333*3*3***33333*4*44**4433**3*333*33*333**33*333333*33*333333*333333*33**444445*55*55555444443333**3333*333**333333334444
33*3*3333333**333*333333*3333*3333333*3333334**4444*4433333*3333*33***33333*3*333333*333333*33333***334444455*5*5*55*55*44*3*33*33333333*333333*344445
3*3*3333333**333333**33*3***3**3*3**33333333*444*4**44433333333333333333333*333333**3333333333333443333*4444455555555*54*4**33*33*33*3333*3**333*4****
3*333*33*333333333****33*3*33333*33333*33333***3**444*4*33*3333*33*33****3333*333*3333333*3**3*3343*4*44****455*5565*5544444*33**333333*3333333*3*4***
33*333**43*333333**33*333*33*3*3333*33*3**3*33*3*44*4444*33*33**33333333*333333*3*333*33*33*333334*4**44444**455**6**5554444***333333*33**33333334*445
3333*33*433333*33333*3*3**333*3333*333*3*3333333*4**4*4**3333333333*333*3**333*333333*333333*33334444*4444*4445*55555555544444333333*33*3333**3*34**45
3**33*33**33333*33333*3**33333*33333*3*333*333**33444**443333333*3*3*33*333333*33*33333*333333**444***4444444*5*5555*5*5*5*444*433*3**33**333333**4445
3*3333*33*4333343333333*3333**3*33*3**3333**33*33*4*444*4*3333*3*3333*3333*3*3**333333*333*3***434**444*4*4**4*55*5****55554**4443433*333***33333444*5
3333*33344443*33333*33*333333**3333*333*33333*33333344444433333333**3*3333333333*33**3333**333*34444444*44444*45*55555**555*4*44*44*333*3*333*33444*45
3*33*33*4***333*33*3**3333*33*333333*333*3333*3*3333344*443*3*333*33333333333*333***3**33*333*344*44**4*4*4*4*4**555*5555*5***44*4*4444433*333334444**
3333**33333*33**333333333333*3333**333333333**33*334*4444***3*3*33***333333333333*3333**3333**34**44*44*4444*44445555*555555*5444*4444444444*4345*4422
**3333**33*3*3333*33*333**333***333*33*33*333*3333**444*4**333**33**3333*333*3*333333***3333**34444**44444*4****5555**5*556*5*4***44**44*4*4*44***3322
333**33333*33*33*33*33*3333**33333*3**333**3*333343*444444**433*3*333*333333*3*333*3*33***33*34*44**4444*444444454*5555555*55*5*544*44**444444445323*2
3333*3*33*333333*3*3***333*33****3333333*33**3*3434444444444433333333*33*33333**333*33**33*4344*44***4**4444*4444*555555*5*5555**54***4444**44443232*2
***33*33**3333**333*3*3333*3**33333*333333333*343*444****4*4444*4*3333*33**3333*333333*3333*444*4444*444*4*44*44*455**5*555*55555554**4*44*444443*3222
333333333**3*33333**3*3**33*3333333333333**33***44*44444444*444*5*433*3333**3*333333****4**444444444**4**4*44*4*4*555*5555***5**55*554*444444*44332*2*
33*33*333*33*333*33333**333*33**3333*3333*3*33444443344*4*4444****4333333*33**4*3*433*4*4344*****4444444444*445*4545*5*5555555*55555*54*444*44*3332222
3333333333*3*33333333333333333*333*3**3333*33*434**333*333*4*44455*43**344**55*5*443434*44444**4444444554*4*4444445555555565*5*5*5**555*4*4444**33*223
**33**3***33*33**3333333**33*33****3333*333333**33**33**3***4*444*44444*5*466*5554434*444**4444*4****45555*5555*55*5555*5*55555555555*5554444**33*2233
*333*33*3333333333**333**3333333*33*3*3**3****33333333333334*44***544*55**6*6**65444*444444*444*4444445555*5*555**55*5*5555*55*5*55555**54*54**3333223
*3*3*3333*33333***33333*333*3**3****3*3*3***33**3333*3*****44*44444444**56566*666544*4*444*4*4*44*4*4*4*55*55555**55555*556*56***5565*5555**55*3**2323
33333333*333*3*33333333333**3333333333333*333333333333*3333*34**444444*4*5**6**66*5554*44444**444444**455555*5555*5555*5*565*5*6****65555*5***5**33223
333*333333*3*334*33*333*3*333*3333*3*333**33*3***333333333**343*444*444445*6*666*665*44444*4*44*44*44*4555*55**5*55*5*55555*66*7**56565*555*5**3332223
33333***33*33333333*33333*3*3*3333**333*3***3*33*33333**3*3333*344444*44455666*66665*444444*444*4444**4*5555555*555555****6*66**656666*6**55*55333**2*
33*333***33*33*33333333*33*33333333**3*3**333333*3*33333***3*3*333*444444*566**666*5544*44*44*44444444455555**55556555555666666*66666**665**55*3**2333
222*33*33*333**33333333333*33*3*3333**3333*3**33*33333*333**33*3*333***44*556*6*6**65*4*4**444*4***4*****5*5*55555565556666666**666666**6*655553333333
**2*233333*3*33333*3*****33*33*333333**3*3333*3333*333**33*3333333*3*4444*556*66*666444*4444*4*444445**5*55*5**5*5*656566**6*6666*66666666*66543333*2*
2*2222*333333333333**3333333333**3333*333*33*333*333333**333*3333*333*****5*66*66666**44444444*444454*5*5*******6*6*6*666666*66*6*6**6666**66633*3333*
2**22*2333*33*33*33*33**333*33333**3*33*33*333333*3*3**3333333*3****3333433665666665***4******4*4444*555*555*666**6*6666666*666**6666**66*6666333333*3
