*5*5555*55555*554444*444444555*54444444444444444444433333*33343665566*6676687377574676777676676666*7
*55555555555555444444***44455555*44444444444444444444433334335656666666676786578*73656*667777766566*
555555555555*5*444444444444*5555444444*44444*4444444444*3*34557666666765*6*666466*646767*757*7767777
5*55555555555444*44444444445555544444*4444*4444444444*3*54336765556*5765*7676646*76864*4667776666767
555*555555555554444**4444445555*444444444444444333333333*64366677666*676*8676647776666646667*667776*
55555555*4444*444544444444445554444444444444443*5*443334*5356*676766667767666677777767677366*7666777
555555554444444555554*4444*44544*4444444444*4433566*33354555576677676768666766477*6*6877654677777776
*555*554444444**555444444444444*44444444*4444*4345633346764665677*65*6676767644476*7777866***7667776
5555544544444*44*4***44444444444*444*44444444443354444*6655*776**67776677667536587676766*76387778877
5555555444454**55544444*444444444444**44444444*43*4343*766647556677766666776748786787776777668778865
55555555554444545544444*444444444444444*444444444*4443577666666666776766567766788776776787*56*666666
*45555554444*444444444444444444*4444*444*4**43434*444677666756**7685777566777*68877657687666*6666*7*
44455554445435634*444444*4444*4444*444444444457*34*4367656*7656667776767677678*777867677*67776667777
4444444344524574*6664444444444*4*4444444444665*6653467665667774***776*667677677*788677777677*676*766
444444*324*476857573444**444444444**444444443677634**6*7766767667**76*767667687757877766*76767*67*67
4444445687467886654*3366444444444*4*44*44*44346643443667677767*767756**677686567778*86**776677667676
444443275664367*565655643363555**44444444*44436644334466677**8686685*7577776766777888777866767*77766
4*43*6547767666668668*5665*76*666*333444444444666644466*77677876656666766667757777577776767776*7*666
4*46365*768886*77676878*666*5*6**66565533*44445666666**6766777667677677777667477876667*7666667777666
5743677667678676868*7687877676676*66566*624344334667**766675667677667*77*76776666888677676*766777675
*654766*768888764566778767777756777666677*334333466666676646*666776*67*8667776*7678778588776*7776676
67446667*68668872*77*6667867886765677776666334333667*76765677576776*777777*7766767*77764776666776676
68656777866**56776777767776765676776666776*23336536776666764664776767777767666774766*478788777767*77
786687*766767878*7*7*857**8468577765667666*23*66675766776*66*667778767776776*7787766757785887*77*766
767787878878777*786776677876*877786677667883346667666766667778776*776667766767777747667887788766*667
66768775*6*677745558687867366877776767777*643*66777766776*76*677768776667667785*7777666677778*877676
73677676*577687777678*787787*6786676766674345666666676777776778765677777668*7677667766686767866*7777
*5677*8767467687667*7*8878*73877777*778844*3767666676667776*766777666*766676*748777677777867777677*7
4478*67*67677*67776*7878855365*3333344433434776767677677766766877677676667767786*76677786767878*7767
777776*7876477766*6776787587667334*44444*443*6777767677778*7*777*7668*6676767656*777*877777687778776
47787776787577677887777685*5676666*44444444442667677667777777877*777**66*7756777767677*668778777787*
677*6887877877*68787777877776766775344333344335**766667766676766777777767776677*7*87765767*777778777
878767878777477*67667656783877457*43*346623333*5*55*6777777677*77787675**76*777*777775775776777*7*57
77*78776776656*787676768*77633746*33444*6857666666667787*86*7777766875777776777778*78467676777888777
7687*888887657876775*6777776777666634335786*6667776776*787777**777*747767777*76777757767666677887878
*777788687877776*777877*7677867776663343242777867777677887788776777757767767**777*6676777877887*8877
5878*87787777647767777*6767764767*77534**323*8666*676667778777776*664667676777777777777777*67777777*
757777788734333*6776687757666676767767663345676676677666666**777788877777677677777677777*77757877676
773*86777644433*46776776*77677676676*877677666666776666776666746776467777886677777577777667776876778
78767677843444333666*76*77*6668767676766777766767766*767756667666446777786677*777*86877676*777666777
77*7787883444433766666**76*687786646*366666777*7777676**66777776**6777486777678678777*67776675**8775
7878787783*444446*66553766*7666776666657777666767767777876777777777685776*57*7*77676776776*776787*5*
67*7776872344446667666676668*7467765367*7777*7786*7677778776777767658*77776677676*76776757*7777*7756
78677678763343366667776677677587877667877776677677667768776777766*676777766766777*76*767777776*6677*
8778*768833*33567677667*76557777877677763377368777777*7787*777776777777777777776777877667776*6476787
7768778883333467677687786776*6877*677676673768778*67777777**77767677677777767787685767677877*8665776
8678776763332666667684877*675876766776852437*77677**7677777777747677777776677665666*666787777*77766*
87877*66*334566666687574*65867*7677776**322*667677*7777768777787667*6777*777776676*66777777766876667
778*775433435663777557468475457*767677**422336677766777777776767777*7677*6767666767676775677467*7457
*767784444*65766667867576775676778777576776323*7*7774*7776777777*7787767777666766765677676*776456675
8778644444*767677*777657*633675787777788876725447*67667776677*7**7777777*7*7666777687777766*6667*766
8787444444567666788785766766636743577767677*4667477776*7677*867*7677777676777766665667**66765556*566
8*7*44444336*76767678*75677458582*2337*767678776*63776*7777767777667776677*66*656566666777666456*766
886344443334676778778755675376763222236657778776777757735456767**7776*7777766655*76556656775*6*66*67
76744*44334576767586643*76322*76222*22267777*77*7676*6766667676777*777777667676*66557*666674*56*6*66
87*4*4444433676*656*646666647577652222467778777*7777*56*6666667*8777777*7776677667676*6*677466766765
88744444444356777846677667667*7555*22**7**7777*7677776677877676777777777*7677666*775866657*66*655766
7853444444*3565*66677*67*777*67778722666677**777777765766777777676*7777*7777777777787677*64677658667
8743*4444*3346*6667667677764266677773676677777777767*6357777776677776777777777767765665*73665778*756
78644444333366667776666653333323336467776*6**77767665652**67735667665777767*6756677676652574*6676778
87743333333356666686766433334336666667666777777776777*6*45587363666*6**7777*77666665*666556656668*86
878**33333333456*766*223*34336766776677666777*6*766778774678466666677746667*767565657853*577*45*4854
76747233364434546*64333232*33576777677*7677*66676767*56767766676767667756*6*6*7667686*66*67747667774
5766*653365*32*32*4433*46654666677*66*7676*7677*6777676776*7*66766777666666*5676587773684667576647**
77*7*664*333333333334367757777667767775767*7756*67666677477676667667766*7766*66567886763557466755457
66776*65*3*33334443**66757772477667777437777*76*66767766777777667767676677767657786*76564435676**688
77676673*33**4444446*76*6*6*2377677766*5776*77*46*6776777676766*6677676676766655556*6657673567475755
*6552*64334444434636767767757*77*77*767677776867777*667*66777766776*65676557568666787757676557357557
*66766534444*4**36356766676566*78*77676676777767776655677*7777*777776657567757*666858776*66746665*76
6677764444444443476377*77766*66376666767776*76776764737566776667677776*67*77666556776667777455*65755
6766444444444444774*3**66777766**66687*677768*577756*677*6*776767777*6566565656565*676777*5455447544
766334444444443353333367666*6*7*6**8776*76767678*865666766777777766675*667756*7*67*76677576*54664556
5774*444444444*3*434344*7766667*667766767*777686*4*66766667664676777757656745*5547666467678646554655
67634*44354444333*333*2*7*776767666777776766*786666777746776666645*6*466667557757**7768*665754644655
86644*3574*444*37664333676676*6766*777*667777767666675676*7667**66654566677666665757555677*646645554
8*7334467444443*766*2347767776*667676767776*666*756667*6767656666566677*6766676656666665886*54656546
766*3*376444443467666*6747677656666*67677776766676776777767*6575*57655555**56566768*6667644655445577
677*3436*4444435676766666776*667877666666666766676777676676457765675*55656665665*747*557654344455565
76*34445444444466*6*766*6666766667767*66776776*66777676*7*475656*676556566766*5*655465786745**554455
77**444344444436*766666*666666*646677666776676646777776667877666556665556665576655*5765865444435*554
674534334444443656666666556666665666666557**666565666776766*66566*666*76566567555656764784*455354545
**243334444444347676666656766*6666666*6667775766667756778747666657655655566557666455777645555*554444
563333*44*4444336*6665**666676*66*7*665666566755664764678*766656665557665*556*56555*558*67*5*4*55444
334443444*444*336667766*56666676*667666666565676667676567756676*677547555556*66*6654*6*656444444*444
4444444**4444433466666666*667666666777566746656766666657**556*5766666755555665655556*755767544*55*44
444444444444443456566666666*68656477*77675666*556777544665756676676656656666666766655486664444455454
44*44444444443443655655*76667766457767767666666555666676755555655556647656664556*66*5574664444*4*554
34443333333*467666655655576667*7775666667*56665666566*6*56*5556566*766656*6665655645*656644544444544
344333467344336666557676777766766*765*7667645*6*566*6647457756666765*6457557766756445*54*55444454444
443346666*33*46*656776*777766655676776676554556765*665*6457556*56*666665556666***5656656564*44445434
44346566684576*6656*66676675667655566*777*56666665*66565655777465*7676666565666677645665547544444443
345576667665467666766667666676675*6*567676756556666665*6657566656667667677666647565*4444457344444444
66*576666765566767766677755666776565556666666566*66*6*4*56565676*66877*5777*477677444445646*55544454
55567766*66654*67666675677566666656666766665557*6556*5*667*56766766665667665644454656676657554543454
556666*5764555555*65755666777666*7667*76666676466**5*5756*57*666666568455567656*7674555*5457*4*44344
5*65*755*5455545555*5555*76556*666666555666666*555555555555757656476766576*67675755456654446444444*4
456566556563555*65*55656756666656455*6676667*5454*65556564656*4766566666665*665566846653463464444*44
67*565554*4454544545554*45656*65456666666*67676665555567566*64666684567567576676644555443754554444*4
55*4*4**544456*5646675*566*75566*7776676765*666745556556555655557665665775567**46575555345645644*444
67665554443545555666455556655*666566666766666676765*566657656565675556*5646776454454554354*466544444
