322**2*22*214443333334*4274684578*846654444*455555555555555*5*5555555555555555555555**5**55555544*44
3322222223227*43332343776955365584855534544455*5555555555555**55555555555*5555555555555*5555*554*444
22*22222234543**4233235225766776425658344*5555555*555555555555*555555555*55555555555555555***5554445
223222223444468442353334865773884*5541*4455555555555555555555555*555*555555555555*555555555555555555
43221*24433*753221432743446572224455454455555555555555555555555555*555555555*555555555*5555555*55555
5431123345726667131*42213662616534476445555555555555555555*55555555555555555555555555555*555555**55*
73254444665577522281333735233352334664555*5555*55*555555555555555555*55555555*55555555555*5555555555
63744453666546*4**435613262775473244*45555555555555555555555*55555555555*5555555555555555*55555555*5
3362176776744334637348217*567554**8*54*5555555555555555555555555*555*5555555555*55555555*55555555555
3*44224676*3*44425*766262*7646*334555*5*55555*555555*5555555555555555555*5*5*5555555*555555555555555
4458*473434444444422233354534544445555555555555555*55555555555555555555555555*5555555555555555*55*55
343*2323445555*4444*44444445555555555555555555555555*555545555*55*5555*5555555555555555555555*555554
*444444455555554444444445555555555555555555555555555555554555555555555555555555555555555555555555544
4444445555555*554444555555555555555*5555555555555555555555555555555555555*55555*55555555555555555544
4445*55555*555555455555555555555555555555555555555555555*55*55555555555555555555555555*5555555555554
555555*5*55555*555555555*55555555555555555555*5555555555555555555*5*55555555555*55555555**5555555554
5555555555*55555555*5555**5555555555555555555555555555555555555555555555555*55555555555555555555*554
5*55*55*555*555555*555555*5*55555555555555555555*55555*555555555555555555555**55555555555555***55554
5555*555555555*55555555555555555555555555555*5555555555*555*5555*55555*55555555555555555555555555554
5*55555555555*555555555555*555**55555555555555555555555555*55555555555555555***55*55555555555*5*55*4
55555555555555555555544444444555*55555555555555555*55*555555555555555555555555555555*555555*55555543
555*5**55*5555555444444444444455555555555555555**5555555555555*5555*5555**555555*55555*55*5555555454
555*5*55*5555*5544*44432644444455*555555555555555*55555555555555*55*5555555*55555555555555555555*477
55*5555555555554444433765634444*555555555555555555*5555555*5555555555*555*555555555555555555555*6246
5*55555555555554444433574624444455*5555555555555*55*5555555555555555555555**5555**5555555555*546243*
555555555*555*4444434676343344444444444*5555555555*5555555*5555555*5*555555555555555555*555554*56657
*55*555555555*44444323*666226233*444444455*5555*55555555555555555**555555555555555555555555444866676
5555555555555544444432246*54646564*464444555555555555*555555555555*555555*555*5555555555554444732645
5*555555555555444447665566*6*76854667243445555555*55555555555555555*5555*555555555*55*55*4446**67655
55555555555554**44*4347*86666736766467344455555555555555555*555555555*555555555555555554*445443*6*86
5555555*55555554444436*6655576675565683*445555555555555555555555555555*55555*5555555555444444*37756*
55555555555*5555444434754754*76767767734445*55555555555555555555555*55555555555555*5554*44444346*773
*55555555*5555*444452665585275845*68*84444555555555*555*55555555*555555555555555*55555444*4443456664
5555*5*555555544444557775477446*85**588344555555555**55555*5555555*55*555*55555555555544444425775675
55555555555555*55444425475566274864887744455555555*5555*55555*55555555555555555555555555*44356637576
5555555555*5555555544*35676641342256*824445555555555555555555*55*555555555555555555545554*437745557*
55**555555555555555544466*85862878*732444455555555555555555*55**5555555*5*555555*554444444*468758678
555555*555555555*55*55*5687666473*4234444555*555555555555555555555555*555555555555554444443577677778
5555555555555555555*5**5544*43344444444*5555555*55555*555555555555*55**55555555555555444434*66587777
5555555555555555555555555545*5444*455555555*555*55*5555555555555555555555555555555*55544422667767767
5555*55555555*555555555555*5*5*5555555555555555*555555555555555555*55555555555555555**44425676687*87
555555555555555555555*5555555555555555*5555555555*55555555555*55555555555555555555555444*36763677787
555555555555555555555555555555*5555555555555*5555555555555555*555*555555555555554*44*44436*7688*6*88
5*5555555555*5555555555555555*55*555555*5555555555555555*5*555555555555555555554444444446*677567886*
555*555555*555555*5*55555555555**555555555555555555*555555555555555555555555555444444443*67667*86778
5*555555*55555*55*55555**555555555*555*555555555555555*5*555555555555555555555554444*446777766877787
555555*55*55555555555555*55555555555*55555555*555555*555555555555555555555555555444444676757667*8*78
5*555555555555555555*555555555*5*5555555555555*5555555555555*555555555555555555444444387466686678576
5555555555555*555555555555*555555555*5555555555555555*5555555*555**5555555555544444436774677*7*87777
5555555555*55*55555555555*555555555555*55555554445555555555555555*55555555555**444675534878877*7*778
555555555555555555*5*5555555555555555555555544444445*555*5555555555555*555*5444*435*7767667487767788
55555555555555555555555*5555*55555555555555554466*44555*5555555555555555555544435677667676455786678*
555**5555555555555555555*555*55555555*5555555*43444445*555*55*55555555555544432677655777786*86976678
55*55555*55555555555*555555*555555555555*5*554*44444555555555555555555554*443366756567668*7768778867
5555555555555*55555555555*55555555555555555555*64445555555555555555555554443*6*744646678467**8677777
*55555*55555555555555555555555555*555555*5455*444445*5555555*555555555544434676555758684485767*88788
555*****5555555*55555555555555555****5555555555445555555555*5444444555544*4777665736754466758*6*677*
555555555*555555*5555*555555*55555**55555555555555555555*55544*4444555*543565767346677*87766566678*7
55555*55555555555555*555555555*555*555555*55*555*55555555554444444444555433685777678876**88787777778
55555555555*555555555*555555**555555*55555555555555555555444444*44444555546763668766777878*876688*76
55555555555555*5555555*55*55555555555*5*5555*5555555555444344*444*4444*54465677785578887778868784766
555555555555555*55555*55*55555555555555555555*5*55554*44*4454444*44444454357*8644688777785777*878688
5555*5555555555555555555555555555555555555555555555444*4446444444444444445667754**87*867466688886786
*555*555555555555555*5555555555*5*555555*55*55*44444444444*4444444444444436*865*6777877778888*87*776
555555555*5555*555555555555555555555*55555*554444444*44444434**44444444444364557776778*7676*777887*7
55555555555555*5555555555455555555555555*5554444444444444444444444444444434458657688887*778877676878
55*555555555555555*5555544*55**555555555554444*444444444*444*44444444444446468476576888*877677776787
55555**555*5555555555*544*555555*5555554444444444333*7444444444444444444*4687866787**776*77*66676876
*55555555555*5*55555555444555555555555444*44543385233*3444444444444444444*6*656786778873366776537766
55*5555**55555555555544*5*5555555555*44443*664246768633444444444*4444444444*7678868777624*7776336766
555555555555555555555555555555555555544*43363325*777433444444444444444444446777788687444477632236677
55*555555555555555*5555555555555*5555*44463**3566783344444444*4444444444444668678777444*37*833366476
555555555555555555*55555555555555555544435*7657868*23344444444444444*4444444*7778774554437664*575365
55555555*5555555*5*555555555*5555555544*33*765668*6665343444444444444**4444*4*8888**55444*6*65677476
55555*5*55*5*5555555*5**5555555555555**43**566675687876434444444444444444444*456444*44444346***77677
55555555*55555*5555555*5555555555555444444334777867787843*44444444*4444*4*44444455444444334777787678
555555555*5555555555555555555555555544*44526777*8877772344444444444443*44444444444444453*32676768778
5555555*55555555555555555555555555*5444*43376676678878444444444444444344444*4444444445*4**26677*7767
555555555*5555555*555555555555555554444444236**7785*6*34444444*44443444*34*44*4444345563333377*6667*
55555555555555555*555555555555555544*44*343667*88875334*444444444444444444*3334334435654333357646768
5555555555555555555555555555*55554443*4334827**864532344444444444444434443*33333*56456523*333677*647
5555555555555555*555*5555555555544442*33*4375266**75833444444444*4444344434333333646565534*333**7777
55*55*55555*555555555555555555*44444777355362256767866*444444*44444443434443333335*665863*335478*875
55555555555555555555555555555444446767666633*668677767344444444*4434343434433333355*66533*3564768533
5555555*5555555555*55555555444674225788857*3688666*77834444*4*44443*4*333333*33335*65*24355*72568233
555555**555*55555554455**544*45855588576354346556567*834*4444444443333*33443333345665433366453*667*3
5*55555555*5555*5544455544*44337656675665643*4324*67776344444*433333333334433333346*6565246633433333
555555555555555555*45554*4*445786574556667****43677686843444**33333*3334*3*333333365626**3474333*436
555**55555*555555555555*444444*466656675233444345767874633334333333333*4433333333456*534343643333444
555*555*55*55555**55555444444446566667653444343*33667777*3333333*33433333434333334566*3345543334*433
5*55555555*55*5555555554444444776*566676334*334445868855743333333*3*43433333333333*65523*33334453**3
55555555555555555555555444434576657856683444*434347887555*33333343333**33333333*334665565**2555*343*
55*55555***555555555*5*44443476*577574783343*6536757765564333333333*333333*33333333676543346*5566555
5555555*5*5*5555*55555*4445657785758876444432767675*775564**3333*3333333333*33333344565656565*555236
555555555*5555555555555444476886787788744*4427*6*6*776655633**3*33333*33*333445534665655566655566675
5555555*55555555555555544434687777*7653444432*876555665*5433**3333333*334354445645565746*665646*556*
55555555555555555*55555444*477775334*43444333*5687665*5644*56343333333444666554665655666566*66566635
555555555*5555*55555555*44444*334*34444444467*68875755544456653333*433455*6665555545*677**6656647756
5555555555555555555*5555444444444444444436677686575646*555*5553333*433553*566665*55567775554*6565736
55555555555*5555555555554*444444*44444444424678865555*55*4555*333344335555*665677*655555576455*66644
