1132233122112131223132122
3211232132231121113213331
1*12221133333111221213223
1121223223333232332111112
231331*131212122221131231
2222222133331*13333122222
3221121133321122332322232
313*123321312121*211221*2
113323113**31213*12333113
332113313*313213132213132
11*221222*3232231*33*1122
333133131312312111*313231
12311312211323*2232132223
3321113313121313321321232
32332323*1231211322213223
2131311233232332121232121
232133311133321133112*333
1133322312213331322113322
332321*12*133121212322123
1221322132*2332232112211*
3113123332312323311111132
1222233132*23333132131131
2*1*3231*22133*2122333131
233*3123123332322211*2211
122322121312*223123331322
