**22222*33333333*3*22212222*1**11221*1*1113**22*2*1122111122*12212224*12222222*211224422213**11*1111111111*11111111111111111*11**111*1111*111111111111
11111111*111221*11112222234311**22211112113*31*242122**1243212212**21*3**322*112**2242222122221*11*111111111*111*1111111111*1***1*1111**111111*1*11111
111111111*121*111*111111111*1111232222*111*3311242233*42*33212*3222211223322*21*32333232212221**11111111111111111111111111*11111*11**1*111111111111111
1212*3*2*22222212211*11*1111*1*1*1122441113*32*233**2*3223*22222212233*4222423222232333222222*11111*1*111*11*11111111*11111111*11*111111**11**11111111
13*2*41422245*13*231*11111111111111112221*11211111122331233*2*12622*22*322252222232232*1*222*21*11111111*1111111111**11111**1*111*1*11*11*1**1111**11*
*312241322*465223342*111111**1*11111533442*321111125*23*23*2*112*223*24322223*3222333222222221111111*1111*11111*111*111111*111111111*1*11111111111*11*
1*23*2*2*22344122121211111111111111122**11111111*134124223*2*22112**2*4322232*324223*32*2*1221111*111111111*1111*11*1*1*11*1111111*111111111111111*111
1111121*1*222212*232445*44*44444*4*33*31111221122134**31111212231222334222253*22*2223*212122*11211111111111*11*1111111111*1111*1*111111***1*1*11111111
**232315352776246*111111111111*11111112221111122112*12212113142212413333122*232232423***22222*121*1111111*111111***1111111111*11111*1111111*11**11*111
222425253637*6354511111111111111111*1*42223232333**6222211*2212222223252*2*32*24333222*1*122*11*121*11*1*11*1111111*1*111*11111111*11111*1111111111111
22322333232**32**112111111111***11111*422121*1*212112*2222221*1122331*4*123*22334333221*21221*211*11111*1*1111111111111111111*11111**1111*11*111*11*11
111*21111*1*2221112*11*1111111111111*1*11111**2212121*222212****1**1133221122323*432321*112*21111111**1111111111*111111111111*111*111111*1111111111111
*1111*111*1211*111113343*454434344421143*222222*21111*3222*32222334*22*32*223223334*22*2212221*1111*1**111*1111111111*111111111111111111*11*1111111111
233343433332332211*2*211221222***23211241*353*23111111121112221222212333222222223*3222123222121121**1111111111*1*1*11111**111111111*11*1*1111*11111111
21111111221*2211223411*1221*2221*22*11111222*232111111*122*32122*122233322*2**3*3432*1122*41211*2111****111111111111111*1**111*11111*11111111*111**111
2541*411111*1*11211*111111222343333*44432221112221111*22*2222*11112**22422*23233453222212132211121111111*11*111111*1111*1111111*11111*1*11111111111*1*
14**1421111*11***1113*3454**2111*22211223445422111111122238*23122222232322232*4343522122122*211*311*11*1111111*111*11*1*11*11111111111*11111111111111*
1121*4324*4443333111322222*23344444432*22*1111221*1212212322223121***32234**2233*5**11*321*22212*11*1*11*111111*111*1111111111*1*11111111**11111****1*
*12112*121111111*1115*221*111*111*11*111111**12*21121231*22*1231211232*22222**25344222*212*2212122211111111**11*111111111111111111111111*11111*111***1
11111111111*111*111*5*111*1111*11111***111*2222221*211121342*22222**2222332232233422**2**221211*112111*111*11*11*11111***1*1*1*1*1111111*111111111*111
11111*11111111111*11411*11112212*111*4422221112322*2123122222*31*12222322*32223445221*22*121212112211111111111*11111111*111**11111*1*11111111111111111
1111*11*111111111122*2*4444443241*1112*11111123*33131122111112222112*2222*224233433322232*12*122*2211*111111111111*1*11*11111**111111111*1111*1*111111
111111*22222*34443333*2222*11*241**122111223322*32211233122*1233*21*223*222*452353*2222***222221*1*111111111*1111111111*111111111111111111**111*11*111
44432222*1111111*1111111*11122**333*22121114224331111242*1121*2*21122223223**2263232*22*2221222121211111*111*1111111**111111111111111111111*1*111*1*11
11*133212111*11111*1122*444*222*111*242*411**212111111*3111212232111*322*2211225***2122121*12321211*1*1111*11111*1*1*111**1111*111**11**11*11111*11*11
111133***1111223*343222*1111*123234422*11*1*2311211*2142*111112223231222232212*3*42*21*1*22212211**2111111111111*1*1**111*1*111*111*1111**111111*111*1
1111242222*4*22211*11112234443211111111213433*21*1111123111214*222*22*222212243*4222122232121222*113211*111111**1**111*11111111111111*111111*111111111
1*11*11152111**112233332*111111111***25*31232*1111121112212111112221121222222*34522*122222121222111111*11*1*1*11111111111111*1*1*11111111*1111111111*1
*1*111114***243*22221211111111111*11111121113232*11**32222*11122322132222*2*323534222112222**1222111311111111111111111*1111111*111111*1111111111111*11
11*1*111222112*1*112111*111**2111111***125125132221215132111122222122123*222*1**321221*2222232*1*2212*1111111111111111*1111*1111*11111*111111111111111
1*11111*11*1111*2121*454111232111*11*111111234*2*112*52*111111*222212212*2*2**2*4*2*12212221122*111*22111111**11111*11111111111111111*11111**1111111*1
1111111*1**112*24532*543121422211111111*243221122254*1*22111221*2211*22132*2222243*121112*2122432*21*21*21111*11*111**111111111**11*1*11*1*1*111111**1
233**111121324*523*1*4*4121312*21131**4*11*2252332332*122*11222*2**2*1222223*22*33*212222**22222*2122222*111**11111111111*111*11*11*1111111*111111*111
223124433422*524*1*22*11*41*244211411*111122*222*2322241111*331*42*1112*22*22222532*2***2212*23*1*11*21*1111*11111*11111*1*1*1**111111111111111*1*111*
14413222222224424*21111114*42*1112411111112*24*222**22221121222221221222*222223233321**22111*2332111*23*11*11111*111**11111**111111*11*1**111*11111111
22*1332*24212*121112*24*52*11111*24111111121**22*22*322*11*1212212*2124222232*23*532121322*1222*221*1212*111*11*1111111111111*11*11111111*1111111*11*1
12*222*311*12*21123352**111*232*3331*111112225213*122*3111*1111112*2112223122233562211*221*112232*1112223211211111*1111111111***1111111111111*1**11111
1151*221133*121***1*111***22222311*1*1*11112*222211123123**114312*222111112343345*2332122121**2222*11*221221111111111111*111111111111111*1111111111111
21*11***2*3322*1*1111124**1112111111*1*11*13*11**312122223*1*42211221222212*2222343*2*31*2*4*22222322122*22221111*111111**1**1*111111*1*111111**111*11
1*12234*32211*11*2344*21111*111111111111*2*212122*211423*111*12*1323112***22*33224222111221*21133*21*11223*221111111*11111*11111*1111111*11*111111**11
23**22111111122*3221*1111231111*1**1*1*1*4222211131221333**2124*1*22231211113*323432222321**21*2231**11212321*11111111111111*11**111*1*111*1111111111*
*2*21*11112**421111111111*11111111111**1*3212*2**1***1233122212211422312112*13323322222221*12222*3*41111312*212112*1111111*11111111111111111111111111*
1111111***21111111*1111111*111111111111**121212212421132*32111131*23222*1**2214422422212231231222522211*2232221121221111111111*111*1111*11*11*11111111
21133332111111*111**1111**1111144111*1111*2121112**1116332111125211423*22112*2322435222221212**12224212*23222231211111211*1111*11111111111111111111111
3321111*1111*1111111111*****1*2331*1*12111142*1131131211111112222*11222*1*221223325*332121221*2122*22111223*23*21121111*11111111*111111*111*11111111*1
1111111111*11*11111111*111*211111112354**11121*121231111*11*111222113*3122222212222533*222*111*21122*11122*2*2511211*1111*11111111*11**111111111111111
11**1*1123112211211*1*111*11112225522*221112*2*3*3222213111*11121*232321322*222*32*344*3212112**212222212222322*221112*12**11*111111*1111*111*111111**
1*1111311*1**2*5311*1*11111122442212*2331*3*2**33512*21**111114221*21442121211**22233335421***2*322*22*21223*2322*212*1*1*11111111*1*1*111111111111*11
1114111111*2245*32111*1111*3411*1*1*14211123211**1**2*132221222216222*43222112****23323*332422313*3*222122*332222211*1121111*111*111*1*111111111*11111
211*111214432*6*22111112**21111112432*1*111*21*125*1111*11111*4221*131*332212321223*3234*522322121221*2*12134*2422221*1222111*121111111111111*11111*11
11*111442426222211*1133*111**33*42*111*111*1121*2*1*1*11211113212152142*32222121*22**2*433*2**2213222*222122324*2*3221111*111*11*111**111*11111*111111
2*242*3214262321*115*11111221411111111111111*421*112*411***112212212*1122321111*2232323235223*33223232*221222323*32212112122111111*12111111*11111111**
1432122314221211*11122242*54111111111*1123122*111**5111125221132212*2222132*12112222222343222*33222*22*222*2*2*334*22***212112111*111221111*111**1111*
3232*142**1111112333*1111111*11*11112222*31121244111*3*11121*1221*311222223*22*1*212*32344322233342221*2222222**34322322*12211*1111**11212111222111122
5233221111111**431111111111111111**1223*21**1251***251*1223*2*21121224113222*1112113**223353322243323*3*21*22222234422223111121211*11112222*2*11**2112
41**11**11*23*221111*1111111111*211334421*23411*234*22721124112111**121122231212223324223333*42*3*32*323321*22223323***22*1*111511*2111**122*112*12322
1121121**343*11*111111*1***111*12*2*12111221112422112312111*1*1211213*2*22124*2122**2223223*32*333333222222*222223434442*331*11122112121111122111112*2
1111112*22111111111111111111*13*3*2231*5211115211*2431*12*2121*411113*22112222*4112*332223443*3333533222232322132*3**2*3232*21*1*2111*11221111*2211111
22234222*111*****1111*11*112**21222112211125*21124*2111*31*22211*1112422*222*24212**22222332323*353532223332222*2*2*23*43233321222*41211112211111*21*1
5322111*6111111111112*111233**221***311*24**1*143212125*1*11111211*121*2221*2332211*224322432343222353322*23222*2322224352222222*2*1*2112*112*22122111
111*11112111**1124*122*4*2*22114422112421121*112311321111*11*11*12211222221*22222*11**11*22**3353*2334*3433232222232232*34233223*21*211341212112*1111*
111*11*111*1*12311*1423111121***11124*2211*2133112411*123111*2112821212214123422321111224232222222*2**3*21**23*2*335222**35222323122111122322*1122322*
1111*111**123**2225134221*22421*133111*24**1311241111**111211111212111121*222*33422111221222232*312*2**533221*33323434222*454324223112222**234222121**
*111**2122**22224552*2*1*242*11331111*5*111311*21*1122211111112211111*1*32*2223222*2111213123*2122322*24*3312*432233423**2434332*221121222112*222112*1
1*111**3311124412211*11122*112*2111*332*241*23111*122*21112212*2111*11*421*21223*2422*1*31*5223*232*11*35*2232122*2223*222322452333**1*22111*224222**2
12112321**21*4411*11*2*2111241112*421*2311**121*11321*1131*1*1*221211*11*2341212233*1114123222232***32354442122222223**22**2322432352*2122*2121232*212
1133*11224421*21*1113211*332111****1232*134221122222213*111*22212211*22122222122222**241212122*3224*1*323*3231222*22323324122322*432232212312111*22222
4*1112321441***1*24*1*232*113233121*211*52211222111221221*21131*1221*1**1121*1223223251*11122322*211*11233*4222**22232222233222*2223*233221*12*112**11
21*3225**111112*21*143*1132211111*2*252*11*2*11111112*1*311*3211**2*112*1122242213222*3*3122222*322*222224342*32322323332223212342*13244*121*212212112
44233*2111112*2112321**44221111*22*24331*22221111111**2*11131231211*2212*11223322*22**122322***21122*1132353422*42***232*2**3222*24*123**2222111312222
45**21111224*111321212321*1111324421111*423*1111*1111211132111321221*142221224*4212*2212*2*12122322221*112335322233232222222*2121224*22123222*21*22111
131*111*3411123211*25211111111**2211112*42111111111*123211*1151*12*12326**1**1*322122321214211211***221*1*254**2222*122222*4222122*33*2222*21112*111*1
11111*2211*33**134321111212*3*111111241411***1221111*1132112**152*12*13223*112232211*1*2*222421112*311*2*223335*2223312221*2222*2*12*35232*32232121211
12*23211243*211***11111214322*1121243231*1121313*1*11111224*125111*112*1*211231132122**22*122321112*42212112444242*2*2122*1212223122222*33113*12313*12
12321*1232*11133111111*2332422122441142112*23124111111221*1**211122112*222122*21221*1*1122212123112*14241212234422323*2221222122223132223*222211121*21
11111343122312111112231**131*1241*4*1112*33114*11111111*122121134*1222**232*112222122131**12324222*12212322212*33*231232*222*2222222122223*4*222221131
1*4**322432*11**111243252*111*222*12*21332**31112*11*2121*2*1132*12221222211223211123322211*2111*122*2221432*1*233*33222*2233142*3*22*32233*354332221*
1*3421422*1211112*222*1*111331*4*112*1*211421111*1111123*15312311221*21*2132222***13322*11111*1141231*21223221*1345225211422212***2**223*643*345343423
1***3*3412*11114524*3211*243124122112411*42111111*111121132*2211421*2232132222*2*221*232621*11*42*124121*3222532234*2212*222224231222122*2222**3*3535*
1122*1*211*1121234212111421*4*1121241113*111*11113*123113211211423322*22**2122*23212*2*221221*11213222211*12*213*4345222*21211122222*22122323232534544
*11113111*1*121121211*2312321121*422123211*124*11*1132231*1411311232*2222*122213**2*22111631121*14*21234*11*2*22332444*221112*3211**1*1*2222*3222433*5
*2111*1122*13111121133313311412222212311132221511114122*12*111132212222*211212231221*14**231**1121*1**231221112212224*56*222*22322111112322*5**42**243
11**12112213*31121*33**3113211*22222*1*1111153111*511111411122*24244**2313*21131123123233*32332112*331*1**21222222123*3*462331*232*3332*31*1*134323232
*1223221233*111134312222*113311**32111111111****4*2*11*21212*12*223132*131*252*12312*1112*1122*2222112**1**421*32222*225434364223332323433*22232212223
1**3352131111*1421242142224211114111111*1111**43*2511221*51**222421412121*122**14*1411111122211*4223121*122***24**13*1212233*33*2534343**223**32343322
3223*5322111124114*14*11412111321*1111111111123*2412*2*2*131126221313132111**11**11111211214312114332*1122222*1*123323311221212325444343444*5335332344
*2255**211124322*12311*2111*13111111111111*121222*13222*35121*3**4*11322122121211131241*21**1421*116222332**22*1111*232243311122121222*23454*22*23*2*3
*42244211*3*212124111231111231**11*111111114223111**1123*122*2***2*11*211221112114222*121*21223*2112432521212*1*11111*2*32231*211232214222233536322233
***2222*342*2222211242111*32111111*251*1123*14*21311252*3222*223211*112424*114115*1*23221211**1***1112223*1*1121211*1111123123222*21313133**2523*44442
21*112242122*14*11331111331111111*43**11*41141*2*1112**12232314*112*11111*21411321112221231111**224111231*232*22222211111111232*23*3323322*232*2234232
*11*34*2*21331**311*113212*111**331111*311311*3*1*11111*322*2211**1111111122*15212223*11121211*111*111*1*12124*3**3143121211*11222221*22**3212123*2224
1*23113*1222112211112421**11*1*32111*221231122111*11*2242221311121222*1111311422221*111422122311111*12122**11**3222112212212212211222212222*24221223*2
*4111311*22*232*111*31112*1*13211*1*32*241113*1111*1*233**2*1124112511112*1*31124213112*32112*221112421*222*2*314*33*221331222312112*1*1122222*2243*21
11*2113211132**11**211*22112321*111***2311*411***11114*221331*311122*111*211212*11*21*2*51**2112*22322**12222*112333**22123*421113*3331***2255244**212
2222**2*12311*1133111231112*211*12411221123111111**24*562221141*142*4*11111312411*1*13321*11*1112213*32532*12*21***32*4211111*2*21212**42*42*321221*11
221*31124221111*2112*2*121411111**11*31122111111*12*11*21211411*4*1**112113122*124**325*2115*1*112222332232222122223*32111*12*2132*211*122123223111111
2222121**11*12311124212221211114321221131111111113*12*22221**11411**11*1*211121*41122*222222*5121*2333*3211111121122321**1111*112*14*4232212221*326**1
31111431*111*21*24311*4222*1*14*113*1131111111112*11*32*222311411142*1*1*412**142*112*12122221142122223*21221*2111111**21111*2123121*2214***1222423111
11221211124211242111121111113311321123111*111*23*24111221421**11321**1112*12124111*2**121*2*21*1152*222212111**232*232*12322112322224321112*112223*333
14**131*3311*32114*2*1111113212521*3211*11*1123*1**212124111311231112*2311322*1122224111*14234212221234322113*22212**32*122111223211*111111111*221132*
23441122*1113311123*111***421*2112321111111*2**2***11*141113*112111*2242142143*211*122142222233*11223**2*1*24232*12*21**21*1*1*121112112111121113111*2
2221133211232111*121111143112211121**11111123*1411111141113*1*111111142241124211141411**15111224332234*1*2122232*2122123233312111111233223111111221111
121242111331111**1*111*32211*11212****1111*222*1*11*24211121122*1111*21311*421**4121113241*512224*1231*11124222433*1221222333*3**11*23211211211122223*
12321*11**1**1111111*2*311241112*3211*111232231*11*22111131131*232***1221221111222411*21212*22**2*342211312214*232434221***333421***111*132**221222*42
242111342111111**11124*2142111242232111132133121111321*2411*1133241*11311*411112*3*123**11*1213211525111315124223*2*213133**32234*21111122*22*1*233222
1112432111*11*1121**3112*111122*1321*1**22341111124*1*3211413311122231*13311131*411321412411111*24233114*421122*32*5113221243321112111*1111*1121222*24
11*32*111111*111115111*2111*2311*311213257521111231121211*214*11112311*1*1112*1221131321311*111122321*2213213234312312*211**12213342*12*133322321*2212
2242*1111*111111114212211*1231**21111423*742231121**3221421*1*1*1111212221**211411111321211125532*2211321*1*2422522*121211311221212*1122122**354444442
33*11111*11**113111*321111**1*321**232*2364332241*124124224*1**1**11**32211*224111414113112312111*11122121*4**4*13221314114112112*11112*11111122222*12
111**1*1*1*111*51**21111132*13211*233*2213*212*124*12242133*11111111223211221611**1*1*31*2**23**111113*13111122*123112*21*322111*111*231221*2111*1**1*
*1111111113111111121*111322132**143212212213*4211*41141**4111111*1114212114*1211**1312*11324212111121*1151321*121221*121122*22121*21123131111111111112
111*11*11*111111121*1113**2321*14*21231211*1*1*312122122*1111*1211*22611141131113111*3*113122*1111113123*2114221122142411411*2352344223141*1*1*111**12
1*11**11*1*11**12*111*321231111243*4321*2**1**124412*22**11*112*11151141221**1*41*412211212213111*1**112*4223**133112131**1122*214113231*1*451112*2211
11*23211111111121111322*421111222***1134*132222211422421111*12111*2*222*11411*411*22121311152*1111131232221*231*24*41211122*222214213331512122*12111*3
111232*11111113111132*1*11*1123124*1122211222121131*22111111311113431*14**2*1*1*31141131431*111111*312*221222123111324*131*2224214441231412111212*2*22
*111111111112321113212311111231*31*1*1113*32131142*2*1111*12121*112*114*13*1*112*121**2*2151*1*1*1411*11412*2314221224114*141111**1*1*2141212*2144454*
11*111*11112311123221*21*1*232231111*2122121*1*4212*211*111*11141*111*124111*1141131*31**112111*1132222*234**12211*21211412311112322131**13121*1412*1*
11111*1*113321124212**1111*42221112*1*14221321511242111111*11**251114*23111312512411211111111111*1***5*212217222213232*131221111311314*1212121213*1*24
111111111*211*13212211122*41*41113*111*1*12213122*2**11**4121223**211*12*1121*11221231111211*111*414412112214*41***131121141111131131412212121313*1312
1*11111132111*311321111124124111121**1212121221*4211*111*11114221221*2411141141*4113111132*11*11**12232*22*31121*52211*1*13111112113*3*3*12131*13113*2
22**1*3411214213311*221222431111311*2*123**311421*1*1123112112221212*41*12*13*2**12*11531**111*1411*231*4213*4*11224111411*1121*1*22222**1313131311*1*
243112*11224**2*1*1*21*212*21**1**4212311152*4311111113*1212*111*232211121*4*131*1211131*2*11*23**32*312*2*1121712*41113*31*11111121*2*411333231311312
3442112*123112*1*1231*311*12*1*213121111**1222114321131111133*124*213112*12113111212311261*11113122131*14*52**21*112*122141*211212*13124*11*1141311312
24*11*1*2*21321122212311*111*2113211*122221241*232211111126221*22212111222211*21121*3211*2*1**32**2411111*31311111211*311*1*222411414124*111*141*11312
121111*122**2*11321*311111*122132111131321242123111**111*113112*22441142*14232*3*11241242*12*2*11211*1*1*4*121*421411251*2***2*3113***24111*11412113*2
11111*231*32111321*31111111221321*111122114211*111252*11111111321252*31224*2222211**112*3*111122223*111124231**2213*1*312*124*1231212113111*1*4*3*13*2
*1111322232*11211**1111121321*21*211*1*125211411*141*111*11**282*312221*31132**1*23***4*31112411*4211111*214*11111*12111211*212*32122*1*1*1*1131211412
**12222132111*2132111*12132*141111*2*2225*1131121*1*1*1111112212421*411*21211221122114321121221*1*111111212211*1*3*1231131*4214231**22121*1**1312123*2
123211*21113211211*111*23213*111111211422**3*11*31111*11122*31*22111223*1*211112*21122*3*12**11354111*1**1411111*4*1241*31*31*31312322**11*111**2*23*2
13*11*21113212311111111312421111*2211232*1*1211311*121111113*123**1111411*114111421111113211211412*6221211*12111121122*1213211*122*31*11*111112*211412
**1232111*222311*1111*322**111*1*11*2*11*42111*211**3*11113211**111114*1411*211*2124421113115141*1111*231311*1111**1311111411122*2*33111*1111222111312
2*231*1*321*3111*11*13213111111*1112*21122111421*12*4311122122111*1**212*114*1*21*2322221*12113411312113*4111111*21**2**1*4112*212222121111*1*22*11312
22211*132123*11111113123*243212111242113311*1*11*2*21211131122121*1*21231*2*1141112*2*1631121*22114422****1111114112*11111**132313433*31111*1*2311*3*2
32111132**31111*1124***122*32211225311*3**11311*15*31112421141541112124*21411**11*2*521121223112*14221*1111**111411211121221*415135321*****2*323111*11
21**1321*31*111112*11321*23322123*3*1231111421112222*11*1*221*33111413211****321111115211*221261122111212111**12112***241**1**1411112241112423231123*1
*1*22123*11*111**22*312133222*23621132**1131*1126311*1411*2222*111*1*111411131111111*1341**12211231114*141111114213411*31*1111111112113111*4141411*311
213*123211111**2222211223223*3*22112*1111411114112321321223*41111*1*31*23112211*121111*2111544111**11212211*11142*42*21213112131*112113*11*41414112*11
14*2232111111*2221211112**345*3**1222111411112*11221131*13113121*211*1*411131112**5211111111*411111131141111**12*1411**1**11414*1113*2311113141411431*
*2123*111*1**2322*12212122357*332221**14112113**321131113223**121114122111211*122223111111211**11111*1131*1121311231*1312**132311*14*2*11123*415113211
21221111**1123122*11321222346732272**13211114*1321*2211321*3112222311*4211*11112*4221*11*1111111111*2111111143421*1***4*4112112111*4*2*1112**41411111*
1*211111111231222*222211222**432*11111*111131221*1*4*124*2*212211221*444*13*1112321*1*1111*11*1321*4*14111*231***31*414*4112121111*41211*12*14*4111***
32111*11112312311*2*2111*22333*21122*3***1232441124112311222*311*4*1112113111113423111*111111114*1*311411112*111132*114131*313*1*1131*11*122131*111111
41111332122124*11232*12*3*2222***12241*11241*21213211321*3214*22411211112111112*551*1*1**111111111*21*1*1114*111121111*121*5141*1112141111221313**1111
*111**112*1111**221111141112221*1233111*2*23*1123111*2133114*12511*21*1221111*34211111111112111*11*1141*11131111212112**11141311112113111132**131*121*
111112121*11**13311112*211232**1112**111*12*21232*112124211111311131111421112121*11111111*111111133214*11122111*2111131211*212111141131*11*12212134411
11*1113211**11***111*221112*1*11142111135321113212111*321*5112311411*122111**532**211111*12*11111**1211111411**141*114*111*12**1114*2211*1*12212144311
111*2321*1**114**1*212*11231111*411111411432*24132322*2112211*11211*12411111443421111311112111133111411111*1111*5*1113121131211111412211*141221*15*511
1112321111112321*1111111232122*41121112222112*1242324*1111*14*1221*112*1111212211111121*1211**333411311112*11113311122211**141111141211111412212122211
*123211111123*1252211*1232*211*22*1**22241112111122*2114411121*4*111132111253*2111111111241112211134111114*1*11311114121114141111131*1*111*1311113**11
*23211*11123211222**1*1**111*31112123121112241112*23312***13113111*14*1*111423211*1111*11111*4**2114*1111511112211*14**1113*3*111121311****1*1112454*1
