55555555555*5*5*555555544*444*4444444444433226*63665*65*656544343344345*476655*666455446566544754456
555555555*5555555555555**44444444444*444*3322334765548*54*643343344434646576555**565565586636766*456
5555555*555555555555554444444444444444443346*6567566654555334333**4545*4454465*44566566655*444555544
555555555555*5555555554*4444444444*44444336567*576545767654*4333335*3*5566*4456*4446875778545745*666
5*5555555555*555*55*54444444444444444433666877567556*666774*33344454*766664556566656*75466666*535654
55555*5555555555555554*44*44444444444467745763322*2623356443244*4456656554635*5668786765746655544564
*55555555555555*55*55544444*4444444444464434333333333333333467546456655575443767878466*6665655*46656
55555*5*55555**5555555544**4444444444443444434443333343333*356*445555543666654777856777777754656*847
5555555*5555555555555555444444444*4444444444444333**33343333465**5555656666685788877667887665**78447
5555*5*55*5555555555555*54*4444*44444444444444*343*34333*324*65644654658678878*7*7677*667887688*5*64
55*555*55555555555*5555555444444*444*44444443*4**673333*546656*45555567757777477*75*77666476858***76
5*55555555555555555555555554444*444444444433334325542226665*655446556577787*47844*4*65485778*6887*65
5*55555555555*5555*555*555555444444444443322333324665*6665*656566665*74*777686685*867746577668*66787
55555*5555555555555555*5555555444*444445557562*22567854*6467565566*446765837676744786566676677774877
5555555555555555555*5555*55555*444*444346*766664**66665664*645**6557454358667778555557666567666*8785
55555555555555555*555555555*555544*44436566666675466666564*56766547436*65676577*46756677665743778677
5*555555**55555555555555555555*5554444437*87*666765778456564655455*554557*5558*67675677*6884*5467776
*55555555555*55*5*5*55555*55555*5554444*435666764*55576556445575344656566466685578664665545574756478
55555555*55555555555*555555*55555*55444*44*5676665555554554445*444554*6785568857875678666556*6574674
55555*5555555*5555*5555555555*5555*55*4444*334*555*556566453455565566557766786665789556*566485667856
*555*55555*55555555*555555555555555*5544444333*5544457556576*6*56*644666677*8*57849*8646*6777767867*
55555555555555555555*555555555555555554444443335554563455567646565*64766647*7779*56566*8666788887777
555555555*55555555*5555555*55*555555555444444345*4**45455*44676*6565*8*676855777776646767*7867767877
55555*5*55555*555*555555*5555555**555555444443355*454376554544557687664756677867668647745*5776677887
55*555555555555*55555555555*55555*55555544*44*4565666466555555*575978545777866766786675676*66*766888
555555555555555555*55555555555555555*55554444434355556*55545567*55747555*78*567867566676676787768678
555555*555555*555555555555555555555*55555*444433355*5545**66664*6*46555*78856654*4777667667667777865
555555555555555555555555555555555555555*5544443345555565*6665475578785*674667685776773657567777**784
55555*5555555555555555555555555555555555555444443464*775*6*66776686*4566*67556*78767*7736578868687*7
55555*55555555555555555*5555555*555*5555555544335*54677754778785*74885575784575**7*6888***7*8856*577
55555*555555**55555555555555*5555555555555*55444544677766567676488*845658766657886877876678665553367
555555555555555**5555555555555555555555555555434665*6*5578885585764637677676588877656667588554533357
555555*55555555*55555544*5**5*55555555555*55544466656*7*7667677684586*666667*87656566555654754333257
5555555*555*55555555443776*455*55555555555555445666**6575658865754866566*58788786534335544*45*44*468
5555555*555*5555555*66667886544555555*55555554*5667646666756665467885675765786454345654444445444*343
5555555555555**555468**685767876635555555*5*54466*76645565555555786755676*6787675567787454444434*433
*5555555555*5555554576768587688666**45555555545676755545*5*6486787533*6*65578647856778676*55*4234443
555555555555555555*376487668767*8787*667*64**367656*4433553*55688467556887*867885554576876876*323344
555*55555555*55555446677667768686666457686*65**6*66556*54456*87864*54468467767865555435*876755563334
5*555555*5555555554788776666*687676656566776777666666*466**5878*5345*5645688665*5555*436655877685233
555555*55555555555467865857*76547885*487765*767786778656446766634*44445868*6555555555444545564755443
5555555555555555553678678*8666774554666*58853567756777*656*7543444444**6**655555555**4435487*7644552
55555555555555555546*8748554*7455446426*6644665**6776687777773444555556555555555555554425885465*8866
5555*5*55555555555355667476*63**38542*6787573468658675886886524555**555*55555555*5*64434346866546865
55*55555555555555435584*558*43*584354556478548357766*87567*7*54555555555*5*55555*5564434447648*76676
5*555555555555*554578677544*454*6*553445754755735674567778886455555555*555555555*577*545445564477*78
555*55555*55555544568554355545*234*4454645*6724554537546647885555555555*55*55555*8794*55554456457766
555*5555555*555444*8645656*3484*53437967666663565*5833356787755555*555555*55555557674555555456666645
5555*555*555*554366*676656694444643787766454665646453568*66455*555*555555555555557*65555555554466787
555555555555554455686776687745768*88643684644655525738765555555555555555555*555555*45555*555*5454668
55555555555555445766864555568998573*6*3476445*6*6*336345555555555555555555555*5555345555555555554577
55*5555555555444*6444443465*444732734453455786*5689644555555555555555*5555555*555*474555555555*555*4
555555555*55544655445545*6*46634*45232455554845758*34555555*5555*55555*555555*544*5855555555555*5555
555555555555557444*4468*43455868545335456567585789*445555555*55555555555555555564856755555555*5*5555
555555555555*5544544546567857755*4636353457885777**4555555*5555555555555555555546687755*555555555555
5555555555555565666674344443745465584745348455673445555555*5555555*555555555*55448457555555555555555
55555555555555435435644344564563*433332*45564774*555*555*55844556555555555555554567885555555555*5555
5555555555555*46745744464*65643*555*444544247974455555555555*55555555*555555555448577555555555555555
555*55*5555*55454453436554334*46676234463*46474645555555554*655555555555555*5554756665555*5*55*55555
5555555**555554584434665*7665755566659378776666435*55445555555555555555555555554865*65555*55555555*5
555555555555*557555*4*46776857655744835665646*674555545555555555555*5*5555555555*745555*555555555555
55555555555555644565657886632463553744***5575734455*5*555*5555555*555555555555555655*555555555555555
555555555*5555*4465434566*66652*4635467*557565*45*55*55555555555555555555*55555555555555*5555555*555
5555*555555555*5554443*4433*34*63795473475497455555*55555555*5**55555555555555555555*555555555555555
55*55555555555555555444434454*3675563377*27745555555555*5555555555555555555555555555555555*55**55565
555555*555555555555554445*55*6574345677664*5555555*55555555555**5555555*5555555555555555555555546**5
555555555*55555555555**3*666*4577757**4655555555*5555*55*5555555555555555*5555555555*555555*5*4454**
5555*5*5555555555555554357*444*55443*44**55555*5555555555555555555555*55555555**555444444555*4433665
55555555*555555555555544464555555555555*55555*55555555555555555555555555555555555*4*4444444544444445
555555555555*5555555*544445555*555555555*55555555555*5555555555655555555*5565*5543664443444454444454
55555555555*555555555444454555555555555555555555*5555564546*3467**65556**74366*55*567544344555555555
55555555555555555555544*6645555555555555555555555457*8867465754563466657666553768684843*6544555555*5
55555*5*5555*555555554455843445555555555555555544583535336932*55474455*44875**4753644678844455555555
55555555555555555*55445*44555343444445555**9344333445**445547435*8*568854453664727454356334445**5555
5555555555555*5555*544455*675645*744344*333246*4434*558566687556645252864272485734239553334444555555
*55555555555555555444344*5853645553763*445343843243444454313236344*876444253*44238784*35434444445555
5555555555555*44*4434*444644769857*4964**4333834665*5341*22182*2**35473363312**6445774*2223344444*55
5555*555555544444344344466535*4295223*34458334*46445554521881*425251345743536533*5256453553434444455
55555**5554444333466564433*44*364135244672683*15743436715112223772764474465454769152*73744333334*445
555555555343434*44*254433453754555235*4*246565*4*322234523*636767867657766777556768846236433*33*44*4
5555555544333*43*326655464645845376721234555556323**331526872587863*333333565766624*72*5433333*44444
555555444*33*3**43*4435*62*7289126*3525*3432111*21334*5857556885223333223222*76353177334333333444444
555*553*443233355366654*5*9869121533232214224*24234375354**6623*443*3*2222*3354522852424333334444444
55555433363337*2443532448*697212425*2323326*222215752647632323434324432222223232*3354434333334444444
55554343*434322333*3*7*46342424444*2182327*213574525734123*4345*4*44542222222*2223116*3233333344444*
5554*354*34**57333674*5546756578523565732*33367694742324*44355444464*4222222222222352*532343334444*4
5**42344431233224484*356**444*655447654*456432***55*54344332565544*1*62*222222222221*48433*433344*44
555334463222344*545464745*778456257*3425427265344552443432345464544452222*2222222*112225432234334444
5*5254546234757*4577587741431434466454788355543434444*333245554*443*2222222222*2211221244423**333*32
555257467*8768677676*4545*5423564323565674344434433*43334355753344333322222222*222221254732322221222
555334344*34374*3355**77675*5456534464412453*334444334324334443333722122222*2222*2132*853*222*122222
554222234*7346*44687685644141*556864513254734333333333232446344*363223323222222*21*22425*32223*12161
54344542344476767575657612552145642212324354444432233323374454333322332222322222221*41243221214432*8
434335414836757643554785362654446*3334344332*23253333233*2463442343232222*222*222222244**44452443425
23*63*664*68645445434973764644**35444233234443333333433344534342222*2*22222*2222222223242*4324344344
465*776893554464*25*6324654*5334334243233333333*323333*33544*3*53*2**2242232222222222234423212333*53
323525664*5241234223334533324*3433423*33333*3*3233333334554433*232*3*222233*222*22222233544326341135
*5336858**33325152242224423**3*434*333343334333333333333543333143*22222232222222222*225132**332*1358
6776632*4*43234244*3423322233*324343333333332333*333*33443343433222222222222225222222*21221223*33336
444332314433331*52333333433333333522*3333333333343333*35224344322222*222222222222222224*221242*32334
