21221*111224*1**111112*2333223221111132122211412322212*224523222*2222*12**2332232***111*1223272*22*21122*2341212322*2*222233232222322*2*22222*24232222
**11111**24111111**112222322**3112111*2**11223**111122312*541112233*2**142*33**5221**21124322*21322321561221212442*22*22234422222232232*222*3*252*2222
11111321112*111*111111222222*1*2111*2121112*233112224213244211222*3222212412422331241111223232*2122521232662222262*2*22223543*4222*224*2*224465424222*
1**11441*11111*322*11*223321*1232111112212*33232235*2213*1112221*222222123223**2412221222112122223252*24233422124****562*2353222*252252*322*244324*222
1111111*111**33333*11*1211123212**1111*22134*122*4562421*21*2**2*2353*22223*2**2**214*11212231*7231*21222*542*22422235822*3*522322*22623422*2*2424*212
1111*1112111*3*332111*112*23441*2211*112*12532232**4133222212242112*23****622422331142221243613*321*322233332222**2*34*2**5*5222225227654222334*242212
1*11111**1*11233211*11111233331213*11111221212*33*2212*2*62121322212123311521*222421***211**2*44**1262223**222223222*4*222*223222262253232233344243222
***1111*2*11123*123*1111123*3211223211111*2212323111***2*22222*21**112242223224*232224211213*1221*126221227642*2242*22222225***322*224223**2*244255322
21*111**11*3111122433*1*111211*3321*211113442421*52**43577422*2222222*2252332143**522322112**224*231332232*2521224222*232*3*2*23226*24234222*24525*222
2111*1**21*41121*53221*1*1112153*121*21124*5*2*312*1233677*222222222**22232331242131*24*212543*12432*522212222222*22222*23344**232*2*32243*23244242222
111111135*2211*1*23212221111222222*2141*2*7762*41*4212**676322222222*22223223*1422*2125*212235255**22*22*2338*22232*3***2333723333*33433*3*2*343242222
1*1132*131111241112*24*3111*1311211122221*56422221*422425532222*2221*2**22322224*12**233211133312*23123122344*23446742*4*33*2233333334336323334324***2
111*33*1*111*4521111456421111*12*1122*312**421*3*223222323*322222222222*22422512422*11*4212*534212243232222223222*3*****3333753333*334335322*2432*2222
1112*311*111*2*221*1*663**111123**24*222221*15*252*2*2*232232212222*2*22222***123322*225222*2*32**124452142223*2225372263332443433343333*3*242432427**
1112*211*12*124111*23*5*2111**12223542232221*55234432*22622242222*6322*22*2**12*2421521232121523*12*5*322232232**24242**3333444443343**34322424*2*2223
11*1212**41111*14532*2121*22**12*2222*2232*122*222*21*22252225*22321211122243331*4212312522*2*842121222222234**22*4*262446*5*55444453*53332***432*2232
11*111*4544222123142*2112233111122222222242*1233312*2251*3222*3212222*212222422412422*2233212221222232*22222442222332*223*45*87*64453*533322*3432*33*3
2*11112444442*32244221*2244221112*322222342*2224222331332252*252222235322212422**23*232*25*2222*22225*2222**3*32232*263344*35776764433533*3253432*23*2
12211*1244311*132422111142**221122*32224562*223322*2722422*222*32222**3**222*4232*22**322422222332122222222*4532*324243*3355567*674*336333225343242**2
113311114*1133122111**21**131212122222254*222222*22*7*2252252*242222222*222423235*232242*2*22*222*2322222*22232223252*43*7334565544*336*34225343*53623
111221111113*64121*13631*2*2224212122323522*22222342133*42*2*22*32122*3*21**2242*213223**13222*222222*2222**2*4232*43*4367*3*554444433*334*26344252422
111133*1*1136*5211114221211*332321*1**222222222234622*722*224222*22*2255222252*224234125224**22233222312222223222*23*253333346544*33*36325**5*36352422
2**21*41**1345411*1*1331211232**1212*2*222**222222222*32*2*242*2**22212**22232*42422422522432*22222*12222222224223224*53*64*55355874336325325*3*352*23
1133111121112323*4222*15281122*12*212223322222222222*322721*251*22222*245*22252232523*22*2342222222*33522222*23*2*6*633*5264*744342432533622524*3*3323
1*2**12212111*1444223*2**21221123*22*22343*3222222222533*21522522*4*3552452214224232232253*332222222*2*2222222*2237*523332*2*3**34*53*533*46*345*5**33
1111122222111*1344321112422*221222122223333*3332*2*228422232*24*212*22212**22242*32223325*225222222222222*32222*33534*25435335773444334236335*4535*433
2111233*1134*1****3*31*426*5*2*2227*222234*233322222242223433225*2242253224*22*2*523224***236222332222223232*2273256****32333*332433324236*7*44435*334
5111*55*21242***1112322121*1221125*343342**4333332*2*2***24343233223244523322224233*3243***233*222222222223*2235434643344*43255438733332342*33553*3333
311*221*3*113*21111332311112121*21232*2323334333333232222223*5*15322*13*4134*223*25*2*242123*52222*3*22**232233*334624**34*223533*3333232333336436342*
*12**22*3*21*2*2431333211112132211322333333**3*3333*22**2223*23*342223*2213522225232*2222233*733**33322*22322223423*543234244473*333332*3*83347436*425
134444*23212**12*12*1262321122*31**234**3333333333332222222**2*4223223**23236222*424232466*33*3*3333*22232332222723*424244*8322333*33324334**374463425
124444422142*111*121111*413113215222**47343335433332*2*222*23225224*22522534332*2*23242233354444533*34**322*3343*22*444253253372*3**33365434336*46*42*
11*4445*1*444112221*511514*2*14*2422226*3*33376333333322*2222***42*32*42*3**2***2*3234323426345*443*35**322***23522424536323232***333323323*34*4364536
1213*4313223*23231211223*322*1132432223233333*433333222***22*35233*4222523*2*3*223524452**4*644**4335*33*33*322*322**4535*22*34323*3*3*32233334*****36
*2122222*21114*21132212122*442*14**222*2*3*43433332233523222327824*2*2222224226*122254522*32*353*444**444*46333324332*42332233322*23*33*3*333355*524*6
2122*123*21224*12521212**1*23**125223*244*3**333333*3222*4**2222**42522*5*242534222342*3*5644*3734*4444444443333*423**3**422523333*3323333343455353436
2112422*11155222*22*211*11222151122*3222*23333*343*33332332222212**2*422232242362225*1*52377253645444643344553*2*42472232*226*3643*2564563743*5*3*3546
112**2442112223*32**7221*1243*231211332*23333433*43*3*333*332*222325*52**42242*2**22625**23236434376444*4345555325223223*722623334233433**4*3445**3636
11111221223112211432322212211442211222*23335333**35***3**3*2222222****52225*262323224223634235444*4543*44343*65554*333*3**3*43*2*323232*433423**44576*
1111*2*1435*1421312*32112122*1323*21222*2*3*333333*3333*234*2**22*3252232222*34334**2523*235*7*44585543344*346565*4*433534***32344222327*44*5444*5*444
32111*1*24141*235**41*1*121*3142533*2**4**2223*3333**322*22242*222*2222*2*23226232*3242*3**66*4475*544433534447*545633442352342*3355*4*334446*56455555
*321*111111222124252***321**12132*22*2*62233*332*3*333*2*22*42222222223**226322*32233262*4334444**44*454344466*5*68*65443262252432*23223434433*4443443
1233111112241112**124111*22111*12523*114233*2*23333*332322432432222224*3*2223*25*526213332*3334*63345**343444676455*64**4*7226***252333244433*46453*24
1123321111111*3*21133221242211121*243*1**23332454*332*732252264322222**3252263227*55*2*72363343445**4455544444354666*8654372252233733332245*878*8*4566
*112242111*1132*1134*2212*23*113*11226*2**2*3*55*322232422222344222222*2242233323*223223436333333444454444534**5*44*5464736323233343565444445565***443
1*11113411*1112222*1*23222122211222152**2244*255433222**533232*222222324125*2*2314*2322*6***433444455484*446555*4564555653558522223*2**323343443333434
211111123211111124*2225216*11221**22152***233223524232222*222*273*212222*2*32252232525223622333433*4457755*46465554656667*54222233232*23355*7334544442
2***111*2**111121122**22332*222*12*2222342*33423342422*2225*25*22****2*2*325123*313*2*734244333333434464634644655456747*56*43333334654*3*5*4434343**33
43*11*1112*21*11222431133222223*2*21*32642222*332242322222253***2*2222222524422**343522323228*334535334433434438**8877775564323452*2*43*44*6*563333333
2332*1*111223*1*1123331*113*43**2222222211332332223325*2222222*6*34*2*2222*345*352243*23*35334353537434*3437444765666776*5*532343*333*45454*4644*65532
133321111*112421*1211*1114221221152*2222232235222*2322522*22223222*24222**5232124233233334*344335443454*5**457575446678564565463*333*34*4454*544865534
212*33*1111**1511*1111221122232*252**2222**4*422232242342223322222*512122**23242253242344343*57*56446*444*44*45*5**564686553546*3444332644**3443*32*2*
2224333**111112421111116512225*32123212*222*2244322223*342*22321322*52122225*23****34333323*635*33*646444354*444534*864455*565484334344*34564442332234
4341222221111*1*3411111**122222213*1251212*2424154*2225*3622*2*2222**4*2222252352222544223434*43423*37434*4454**5*54**6**4*45455462333*465456443*23**2
4*1*11232*1111111242111*114*211622122122223314124*32232422522222*3124422*22233227*2233*3*4444*54322346446*3*534*37**34*43645433344333*6*35456556433**3
14231*222312211112242111111*5212222322622122*42*242522234223222245*23312**22252*2*3*3433434365334*3*4*4*564*5*5433354*45*33343353446344*345*6454443333
12123*2323*4311*1*1143*11*1225212353221421122243228*3332331322122112122*2*222253235645*3*3*844343634**4554*23*3365*364*43*433334*334445433443455445*2*
11**26151224341*11111*4211*2*5212241332**21222222222*222143232222*2222*222*2*25253435*3444554343354456*4343333253*73422*43343475453*4***3*5*3645744432
1*1113*212213232111*1122211121*3621624**14422234312235*22*622*22*2222222222222164322*23*4*74444654554453233*3*554334*4*334434533344356533*5*444337*44*
1*1111233*41122*311*11143212121422254125*342*2222222236*2226*222222222222*222*322332344566445*54436464443323222*52**3*334334*435377*54553664*6*35*7654
1111111**32*5*12232111*11331*1*2142*2*1*6*23*22122222*226*2*5*222*12222222*22**22233446455*344*3343542346352*42222354222334534443544*755454*54*44***55
1111**2112232221*3421*1111**11*13*13223114222232222222222621252122*22222*2222223*2**4644464543335*443435473222233335234333**53345*36565*5*67*455557764
3**111111114*3121214311*111342121212242*22421****22222*2225*2442222*222*222*222362*34337*54454533346*325532*22**322233346*345445474*4445555555*666*476
332*11**11*11232211124112**1131111124242223513121212222*2233112332222222*22*22343333355334542*44*43662*24*3333*2*34*437*5554*2444453335*5*676544446*55
22*31111111112221111*22121111*421122*121222262223**212222*241113422*22*22212*4352*33343543*34*3344332**3344245*444*33454377674***252444*46555845*84546
12331*1111113112*3421233**2***2522232*212112222*2121233*2221*2131421*2322122425*3332*34233333333465233343**7234344**565*664657524445*555*4665456665664
11*11**1**1*211***3321223421**2233*2222*122122322*22232221122642*2122224132323***443*24422*2233322222*223244*23*4854*434*3556*5*8*33355*664587*66*6*45
111*11111111111111523721225112221222211*222222*2*222422*2312224221222222**3342233222*35222*3233**24232473523443545**47*553443*424346*65543457*5554555*
1111*111*111111112*22321212433321221111225211221222*214322321224211*2222232*2352123222232432*2223232384333*434355*4*554*4432*3*2344565555565866677554*
*1*311*2*1111*1*11111233**1124223112****2151*2122*4212*423*23222*2222*2212*22221*2222222*46422332356633*345322*334**4554*33**4555*444454*55*46668*6746
112211*3*11111111111112*5121*22*322112*22114122123*512**4**2322*25222222222213*32122222453422*332*3*2*4443*3334344573**344*445454555454**65*555*4*4445
11111154*1*111111*12*1111224222*2*2211221222*1123121622*225226*22232122222133234*21*3*344422332443325*3***34244342*454333345555646*4546655*444444*454*
*111***24211111**1*1*111216122*13**3112*212214**22*223222*32212222*512**2*22221222232*4*223*4322233434*232345*4**6544753*54665435566555*6*435543334*32
1*12111152111*111121111*2*1232*22243522212222*4*22222232*234334*41*23222*22135242125*33223*32*44224*2234*34*4354454*434664655463444566*54*774*544*4454
2123111*1111311*11211112211222221*222*21212212122212113*211*122234215222*13**2122112*22121224*233433352**34*44*3*3334543644*364467666777757574344544*4
*1111*2111*111111212*31*122*12241*11*232221*1122221*1222522*85*22*3*22222**22232222232*1332332252*334*333*5*322*323**4664*54*64*6*4*364556*63776**4645
111*14*1111**1**3111312322121121433212432222*22*2222*124212*2222112*2248222*2*22222*12**25336*322233233364223*3333556445446*46*3365556*5454*53*55777*4
11111111*11*1*1*2*1112212111222*1*26*234432*222**222*22*322522*3241*223**2332234221*223*32*43234*33437322334*42354455*656646*4655663433346646566*77*77
111*111111111*1*1123*1122**2223212523122232322*22222152223432222142*225*322224322112233*2*5233*3*3454234**2*24345454345553666546*33*4444446566555*6476
111*1111*12*111*2112*1111332121112222312122332122122*22*22*4251222622*32*2*34323**22422*432*353*43*33334444*33544*44556656*54564353633436344336*545*43
111111111*2124*11112113*12*2431*23*1113*2124251211226*222*2222512*2233123*2*2222322*22334**3335**42*434343*5544656666*5655445344**4*4466544*533*33*435
11111321*121*3311111**2221*3321112141*232*2233*33*2422*1222*24232*3*23332332322*2242253333*3332532*42446633**5566546565344433345664553454553343*4333*3
12**1*112111111**2111*1321*11***1*221*13**1232334111*222222*123212152333322*222233***52333*2327*2333235363565*4*66***36**554466533665*343333*6334335*4
1*11111111*31121124211111*11111*11112211*1*11123*51221111*2222*31252**32**2*2*5*34432343312*2233523343445*34***6444456543452*22*43***3433343*44*666353
4411211111221311122431111111111*2*22*1121*11**21441*22121311*2222723232*32223215533333344332*332234336446*46653554435*3322*2223222*312235333*333**33*3
111*31*1*11**2*12*121*11*11****1*232*2111112*3**11*431*222***1*2*322332322*32**34222332523233244223643334554*23343*33*22*33*22*22*21*22343333335333*34
11121431111111*11111*111*111321*11111*111*112*2*21232422112*22242*2333223*23223**33*53234353343223443354**3*34222221122222211**232*2422222454*333*3355
11111311*121111115211*12411232*12*11111111112233124212242*32223322*3**2323*23*2323332*3*33*334**334*444333422212211222*2112*322*23*22221222334535333*3
11111111114*111112*2*1111*111112111*11*1111222*22*3221312422*242*34322*231233*33*33*523*34*342*3*64454332222**232224*322222222222212*22*2*22333*35*533
224211*11**113*12*1331111121*1111*31121*11111322*2142212*2***623*323322233*223*242*224324232*2332***5*342*12111222*31111222*32222*22343333342234334334
25552**11112131211*1111122*2221*11*1111**4112*124221255622*362322*32232211*2*225*23*2522434324333***62*122*11*1112121122212432232333223224222322*34*33
264524241111*2*2*33211112232242211112*1122****11122212*2*22232232252312323422232512324434*3323*4434*22*22*111232122322234232*2326*2*442*323522*12*4*33
1333*323221*111113341*1124**34*311122112421214111*22213*22**2453*332312*12222222*2534*3333443*3353*22321122122132*222*123232333342*432232**33*33*33543
*12**322*312*1*1121111*1***32122**12*22113211111*211122*1221*243221*1312*313334433*353343*235264332232111*112222*222*22423333**22**2231232343334423224
1131131**23*441121111111213*421*11321*122121*11111111*21132234*332233232212*3*33*623*223433222433221233121131*1232*222233**222*322*222222*222524244333
21111111413223*2121111122113312*111*1111143221112*111121212123*222221*2*125222*24*23**242*332*32*21132121*32*22*3*32332222132*22111121222*3222*3*3222*
2314*1121122*243*2111*1*1**1113*121**111111*32*11*1112135112******2332212**33345324233322*2232*23*1113***21122*2232222222122211*2122*221122*2122*2*3**
22*5211211*2*252343211111142*422241111*21*11*44212*52123332232232222*212225236*32323322*4*522*11224311*21222*32*322122221221*1112*21231222*1*114222*32
111*222112111*1142452*11*1*1*1111222121111111112*12*235122423211*322*13*33*333332322**22222*1**121**22*2*32*23221211111121122*22221212*22222*2211*22*2
1121121**2224211*1**11512*12*2111111211*62**111244*1114322232312312*23232334433*3*2322***11*31231*1*321****32*212*2112222223232223*122111*2*21221112*2
1132121111*332111*121532**2*2111111112112222121223421*122322*2232222*3223333532322*2*2212211222122*11222121222*1221*211*13212*2211111112*2211121*21121
116221111****41*2*21*1122234211111*1252212*1112532*36221*2**124*212*12*4*33*32*2222442111122*41*12221222*22211*1112111*12*2122*21221*112211111111111*1
**321*231112121*42*23121212422111111***62111**12*2322231*222422*2132333334332232*153111***111122*122112122211121111221122***22122*22*122122*212*2122*2
12111*1*622211111225234*1213111111112*42141311213124*11231*223*22*2*33332242322122221211221212221*22*21**11122*11*112222*321*22221212232*1*2223122121*
*1*1*2*2*2*32111212*22361*11*31*11111223441512211***223224122*13461*****24232**111112112*21**1211*122121*12211*12*2*2423322*22232222*23232*2*2*4211211
*1*1*11*2113334**111144242222*11111**1*1112312422*22222432*234222*2223323432222*21**22*13112121*12111212111332**22***23*2122422322*2*222*32222222**3**
*2*111111111122111*11**142143211***11111*1111322321214*232*252332*224333*2221*21*12122*211*22231*2122221121*211*222232*12123*2222322*12*222222*2222222
23432111111*1*111111*1111223*234311111111111*134223*2223*12463*2223233323321*32111*11212122*1*22*12222****12212*12*2221*42*22*21*11111212112*221121112
11223542211111112**111*12*122*11*12221*1*1112112325*2112224232*22*33*3322222321*2***51111111222*221*2211222222213321*132122*2111112211112211111111*111
111112*34211111253111111111122312124*122111111112*14212222254*2122131332222422222*1122*2112212331221112*22232*1*211*3222212121122*1111111111111*11*111
22111*1*12***2124*11111111**122212*512452111111*111312212**31322312*3322422*21112*121*2221212*21**2112***22323*2*2113411*12*2*22**11111*1*111111111111
4*4211*1*112*433221111111121*1*13**1141**1212*111121*22221**22*21*3112*52231121**222*1*11132312112111**32322222111*3*21*21121*111*1111111111**11111*11
1*235432111*111*111*1111111221212531413111141211111*112**222*22223132*324321122*222**211*222*122212***342*312*11122121112*1**111111*1111111111111*1111
111*1*123*775321111111111*241*11452141212*11222221112213*2222321332*2*323111111*11*11225*212212121323222221*2*22222*1*111111*11*11111**111*11*1111111*
35**1*1212*75321111*1111*1221111221*1*11*721*213521**23*2222232*21*322322*12112221***12222111112122*23222*22232**21111*11111**111111*1111*11**11111111
112343221224*2*3*21111*11211*111*11*13112*26*11*1233*22123*122441*1*232221**121212*113222112**21*122*223**1222221121*1111*1111111111111**1111111*1111*
111*112*42*2121225*11111143111124*13141211113241122*52*1222223222242233121121211111142221211122323*32131122242*121221*1111111*11111111*11111**11111111
111*1*132454221*132111*11*21**13113112*11**11225211224*122222212322*2222*2212212211*32*111221323**422211122221111*11111*1111111111111111111*1*1111111*
1121*1121111245*11111111111111241151311111111*212*3321*121222222122332*1131*411*212222111*1122*334222*12*22212111*111111*11111111*111***111*1111111111
22*1111*243112123*321111111111*21131*11111111221**42111331112*22***2*2212*22122*1222*2111223*33332221*2*22*1111111111*111111111111*1111111*1*111111111
113443211111134*22112243211112**151311111111223132*2413224211*2223221***1**111*12*3122*112*23*34*2121*1211111*12***111**111111111111111111111111111111
11111223*22*11*13*32222235542232241*1*111212523124221123*21422*233322**2212*111225111121122233*33*1211111212**21111111*1*1111111111111111*1*1111*11111
1111111222*432121*22**32111245321114112111*1442*243312343***122*3221211**222*11**221*11232433322*21122322221111**11111*11*1*111*11111111*1111111*111*1
11221111*11*1233211112**4221122231**116323121122332112*2*1122212*322*21112112211221*2222*2435*33121212*23121*1*11*11111**1111111111111**111111*1111111
212111*111111112*43211111233*2**5141*141*132111162311323*211*13*3212111*2212111111121*3*222*2222*22122*21*111111111*11*11111111*11111111**11111111*111
3423122111111111*111343*11*1234*113112511**242111252*4142*431223*252221*2112121*21*1222*2222*2111211*112211111**1*111111*1111111111*1111*1*111111*111*
1312*2*232111**11*11**13442**1112411132112*1112*2*31*3*3**21*12*223121111*211*1122224232324212*3112*1111*11111111*1111*11111*111111111*1111111111111**
2111232233*2*111*1111111*2*34*1*23*1131**2**11123*1*24*2*12*342322111122**21*12232*12324443222212122121111*11111111111111*111111*11111111111**111*1*11
23*24531*22132422211**1*22*11122111*1243222222222*1222311*2223623*2212111211211*11*2234424*2322*2111111111*1*111*111111111111*1*111*111111111111111111
2422322*3**121112*442*11131*1112111**21112721*22*21*131112122*22122212221*1211112*2***322221221*1411**1111111*111111*1111111*111*1111111111*111111*111
15432*21121133221112223**11*1111111142111222*222*222*32*122*22*231323121112212112112*3*3**23*121111211111111*111111**11*11**111*11*11*1111111***111111
*232345*11*13211342*11222*422*11**114342*12**222**1121111112222232*12*32*1111*12**1224212433221121111112**11111111111111111*1111*11*11111*11111*1111*1
111111*1234**11111133232221223221121111124*11122*1122111*122212122*2*21213122222111**2232*33111**111111111111111**1*111111111**1*111111111111111*11*1*
1*11*1111111121*1112111112122*22342*21*122123*13112223122121132*22*2***112111**2121223*2242***2*1111*21211111111111*11111*11111111111111111111*1111111
**123*2*111111123311*1**11412**2**235421*1*1112*33*2221*22142*23122***222211*2*221122224322*111*211**11211111*11111111*11111*111*1111111111111**111111
322*1111111*11111*11*234**1111111*1211124*432*2222*1232**12144422*1122222*11*1112223222*3*221111*2214111*11111111111111111***1*1*1*11*11*111*1*1*11111
2223543322111*1**1*112111*444311112**1114211*3322*323223121232321*2222*23112312*252*2*23331*1111*21112111111111111111*1*1*11111111111*11111*1111111*11
111111112344**221111*1*111111123443*11*242*22**22222**2**12242***211222212*1111*242322435412111221*121111*1111111*11*111*111***11111111111*1111*11***1
2*21111111**222344*222211111*11111*224435211*22343222132112232**311222*212111212*3424*243*1111*11*122111*11*1*11111111*111111*1111111111111111111*1111
444*3222111111*1122224*3432222111*211111512133222**3222222*143212*11222*22112422*222*43331112112*11*111111111111111111111*11**111*11*111*1111111111*11
11111*234333222111*11122*22111242211212*3112*2*222252232212213*21111222311**23*2*222*34322211*122**21111111*1111111111111**1*11*1111*1*1111111*111111*
11111**122212*354322*121211111211111112*2**22323322312321222*4**12122**122123*2222122422*11*12111211111*111111*111*11**1*111*11111111111111111111*1111
1111111*1*1111111122*4432222**211211124142*21*222322*1*21**3*322*123*22222224222321323*21112212*11111111111111*1*11**11*1111111*11111**1111111111*111*
44*43322111111111*1*1***22222243111*2211***3*332232222111144*21121112231211233***2*34***24112*21121*11*111111111111*111*111111111*1111111*11111111111*
11112223455543222111122*11111322*112122*32222112*23*12212*2222233322*2*1123*32122*222325221122*1*11111*11111*11111111111*1*111111**111111111111*111111
1121*22111222*22234443*2221*122221111111*112132*12*21211*223222222232*22224222123223*2222*122*211*111111111111111111111111111*1111111*1111**1111111111
11224*3*22*22111*111222222*3442241*4*421*1111*222*1221112***2212*2232*222233**22121332421112*2*1111111111*111*1111111*111111*11*1111**11*1*1111111111*
111112**22223443*32221111*111122*2111112343553*12321*2121*224*1**212322221*222*3*2*23****122*22111111*1111*111111*1111111111111*11111111111111*1111111
*11111**11*111**1222222343333*2223**11111*1213*1232223*1*1*2*22121*222*2262224*22233*432112*2*11111111**1*11111111111*111*11*111111*111*11111*11111111
111111111111211*111111*11*112132132111111221121*2112221*22*23221122232222222221*212*234212*2221111111***11*11*11*1111*111*1111111*1111111111111**11111
