455*555*55554*44444*455544444*444*44*4*3333333366566657**758565*6*767*77666
55555*555554*44***4**55*44*444444444*4*443*435**76*6667676*77*6676*66666677
555555*55544444*4*4455554444444**44*4*4*3343466555766666*6*5*68446677756766
55*55*5555**44444*4*5555444444*4444333333455*6557*55677676767*6667*66667776
5555555*4444*4*44*44455*4**444444*43564*33456667666576676666777767625676*66
55555444444*555444444444*44444444443575**5674656*7*5676*68*4*67667664776676
55554444*44*5444444444*44*44444444433*343667676666676**765658776*766*877*77
55555554445*5**44444*44*444*4444444334*346675*756*7656*666*88786688*665***6
55*55555444444*4444444444*4*444444343*4*66*7666777*7766*6**7767678776656666
44*5*444435*43444444444444444*4444663443675676576876776767857767876*7767767
4444*44*4554445444*44444444*44444**77436**667*855676668675*787676*7667767*7
*444355738578733*44444*44444*44444*6344367577767676*6*6788*7*7867666777*6*7
44*46557*37658*5443435544444444444*644346666*6776766777767*77768*7867*7*7**
44367*6367*6778688656567*763444444*76636656676666766776*7667788677686777*56
6635676677778578677*776*765646*434*446666*67*666666**66*774*7878777766**76*
576746786*7*46678*6*77*676***6784*334666676666667776**667776678*7*877777*66
7767788*67864**7748*67**667*67674343*66666*6678*767*67**66**66778*7*6777666
7**577766*7768776875656777677*663356*6776666*675*7767767*6776567*8*8*7777**
7668478*8776788787*8776777*776772366***66*686778*6*667*77*7*76667786887****
66*678*7777664767778666*6777*7*7346****67768*77667776*77775786677*778766776
66787877686*76867*6877**77**6*7337*7676766777777778777*7**7777767*68**77*76
46777767*77778777686***23334*334376*67*7677*66677676666*7778876778677887776
66*77*867676*7677866666644444444467*6776778777*776*776667746688*76876778**6
667*68*676777***7*7*7767663443344*366776**668877777677*647*867*6*7767877877
8786*7876467667*777767757733*663335543766*7777767686755477777*875**87777776
777*7787777*7*686*7*7*56*643377767667767788*7*7*77776*7677767**4***75778*7*
88767*877776*68887876*767773*43*7776667767777777*77577***7*7775777776787887
577786877*477777767*66577675*444*7866666677*7777687*77*777777677767767*6777
*76**777433257*67*677676777666556667777*76756667*7777777778777677765657*7*7
*7777775**333767677677666*767677667*7767*7756*654747777576777647776*7666*77
*7876883444*756667*77866666*3766777*77**776677*77757676*466*7767677*6746**6
6687**733*4376654674677677676*767*76*76*8876776777766*7**7777777748*6787667
88877*753436676676*77776*68777676767***76787777776*777766777777677777677776
8878**823326*6*6*6*74768**77*733737*7777*7877776677777*77*7677777*7*6*67677
*67787*4336666766667768777675678*7885*76776*677*7*6*67878*77*666657*6757786
77878**3*467**76564674676*767752*677*767*6776*75*6677777*776**77677*77***67
78*7*333*56676657*834477*76766423377776777766676*7*767777766776*7*5774*7*78
87773444567767867766775757766*777*67777377***86777777767*6677767677*666*675
7765444**666677**7775645467**6766366*7667777775*77**77777777766776657644656
*78*4444**67*7*87767556722*****668*7734756766*6777*776777**5*67667*67646*65
87444433377786777*66477622**2*677*77*774666*7776677677776765655554*655686*5
8834444447677*657776*66782*22**7*777677767677**687776777**776*77*767657666*
8*34444435677*76*66767*6572225*777776777*676767*76*7677*77665768665*766654*
684444*43*65*768*777676776636*677776*66747*666677777677**7*77777566675*5777
773*434*3676667666633**2*4*6**6*7777*6*46237**377*737777777*765644456756655
*7333333355*677775334424*6**77667767*6676*4*575666*6*777*77566*7765**5678*6
675*3333334*5677*334336677*676778776767767*6*6776*67766775*67*76646*745*775
6*6*63*63332353332*323677*677676776777766677*67766776*5766566765545*855*647
777766344*3334344*7567*6767**7677*76676*66*7**67767766777766677665565655*55
667665333*44443*66667257776773*676*66*7*6*667*65677665754666**774*365*77646
6423*43*444433476666*736777*66*7777767865666776*76***6*56567567667*64587655
4776734444433326676666*6876***76*7*77*6*56777776*67*665*656*67486*45746755*
6*663444444356465*6*776566667676867*7757657776*767776777757567867777354656*
744344444*337433377**667*66*6676778677*6677*76777567667676*5*77654876564454
*75*44*4444353*336766677667667*777*66466*7667647677765576556476677*7*476*46
6*5*445*44433743*6*6*7*766676777*7777656***76*564*7665577*6466567566755*5*4
87*44574*44376743667*7667*77*664*77677*67676774*6655**6*667665*76*67745*543
7743466*44436666**4*7766677*6676*77*7666777*666555655557666575665*653***556
7733444*444767*765*66*666*6666676*766676**6658766666655*567*657656764545544
*744334**43566665656667565*76*766667677*66677674566*56765575666668455**5455
67**4*444**5*6*666565666576666*7*6***7*67*7856*56646*6*7767*566*76844*5544*
7753334**4336**7*6**5666667666*7756767767*7777667*756655656665*665545555*44
3333344444**6777***6665676677566676*6*6657*7*656*7756*55676**6655*64*54*5*4
*44444444*4*46***6*6676*66676*66666*67**7*75667*666*7556565655556*743444554
4444444444*4466657566675767*777656656566776455657665665*65656665*5644444555
34443*3444*6667554676*77*767666*777*676*775*65666567465756*657557655*444444
34*3467*43456*6775***66*6*6577676575567*674675666667657*67*85555*566*445454
44*5666844665566677656657766*6646565656*7*776576565***65*566675456564444444
3**7**6*557**676666566775566677**6556655576**55566**68**75*5674*55*5344*444
666*766745576666657*766666655*667666666656**6565666776*5446*76*4356545*5*4*
*6*666*63656667556*66676777*57**6*6675*75*65*56*7667866666564576*7453344444
57776*534*6*5*5656**5565*6*775*66*5*55*5*4556*6*67*766666577766554434554444
456*54655***6555557*6666645667667566*6*5*666665666*6**666665655*44456644*44
6*6654545*44444*6555565556666667*6665556565676457*5566667666*744**4*4444444
666455554553*5666566675666566*7766646*5555**564*6465666*755**657*546646*4*4
