1341221144*4113
244*21121223**2
3223*433333*123
24132311244341*
334312231221321
1112*1424333114
1*41*33432*4224
*2143221243*13*
11*11411*343333
423324143244342
34411134*241123
2343*3***433122
441**3113*334**
*4332442312*122
24*334*12414111
