87*8*778998789799979877898789777987799789778978879887997*797
8*97879798777789999979977987889797898977988799989*7978888778
99978*889879878987788878777977787789978789788778879797978879
9*777778988898899898*97987999779779978977*9788*8877978978797
797977788897777999898877978799898797899777787979799899787798
998987888977997779977779999988789897977*988788779999988*779*
98998998797899977*77*99879979997*7978979978778*87797799*8799
8*98*8*99999879777987899897878887988887879978797978787788978
777899**898989887989878979*988797788989797898779989889998998
8*789989*9777997799798879778999*999887798798887887*879779977
7977*8779787889899799987997899998789888879988988977879988987
87997998899799899797897879989887798877*877777778989879798979
77997779898789998787997779977977887999797879799*797*78798989
79879897998778978897877888988787787879898987988*799787989787
889778789**789877778997779*7788989898979897877*9777997889889
9897998898798987778989*7898999977988998778787787997979777878
8779*9888897799988997987778878977*98877787878787989998897788
8*7*78787897799888979779899889778879*88997897777797999897889
977998789*7*78989798987778988787977999*88*988779999789977778
79797887999997978888787*9*98998787989898779778988978*7797779
9898777978789897997998777898878877789798977**797978979897988
7878988799989887*8887989877798989987778789878989*8777778797*
799798987888*78888988998978999777988998898779789887877877799
9877878899978779788887997889*987899987*779999988877877*78797
87879778799898979*797979997998798798887797798998899988989988
898897879777979988898798978798779797978798877787998788997797
888877977*99778789987*98778878989897998779899787887779998998
97788779977887787777987878899778987977889979789*977888898788
989877979788887888*998998988877899*79978*8787888989777999988
9979999899888898789988779778898*7778877788987*99989989797797
8787778788889797788988789*798879799987888897898888*999799887
998997*7979978987798987*779987899879977787*8997*7887989**897
88789897887898778798999897997987979997*878997*7788998789*889
78888779788887799798978798*87978*9799999788897878*8887989797
87778898777899979988777897897798989778899999789899*899977987
997887799989888799979977*79979779887879877799777788979778777
99987797987777878*798897799779978988978789887887798797798999
999799979798889989988989998899898987897789*78987788779798788
9897778899997799878787997877888999799*898888898987789899877*
979889798989988887788799897797999977979798878998878897988897
977988*987999789898897877787979987777779979777799997899797*8
989887899988787979979999897799778789897798788877879778997789
998987977*7898*98888997789987988978898887798987888997*997888
799999987779778987787*9777989799997798789*777987988897787897
8789888997*8798787889977*79887987887878778997979889*89898987
977988889779877999988997777998977979797778*7799788798897888*
98988889998788878999998998989977887799*7898978797*8798898*88
787987899977889789898889899799*79788777799897877778*97878999
978879798898989977*7987878*98889797977997899779988787*888897
997898878898*879978778798777*788*98998*877*87878989797789877
79*88788*9998*8778897988879*99788997877989979797977778899788
87797*888898789*89878979978878987899787798979889799789*98879
778788979979897787898797979*877888998898*8879978779999799888
89*988789787978*97*9797877978798879888*878898*7*998899977778
888*798999899999898899989898*8797779897998778777787979*88779
989788988889997987878798*788*77799799*7*7987777978789899*999
977978798977997*9879777879979*997779799777979888789999999878
898*989778*88798899798988887*8897789977879898798978978788888
8888998878877877889777*9777797*8898988*998988*98979977798897
898998878887889777*9*9998*88888779899799799*9999987897*87787
