323455554332345*68541255233265554452344296653534674653443*555485553374245544553332213446577845*6667675876464678435665356534*55675245*77841222111*21125
4533323422333546422236*353*35555342444*665645392665936244455452236344444543454333111446568672775668766766*667883*57731653336556624*577*21211111*11*115
453444444334545225445343113253424454*356155736735864*6643434*755554444455443443421114455687738868686*77654*66774665522543356666644668711111111*1111113
4543345546*32446445555414134533437554513524566573557656787866645*434455542436422121243555*93*7576766776757578744765513654666*8758862111121111111111112
45435445442346435577841234353244626552342645456552768655787754557*55*6543263*32*323444*655638656668576655568753466441453666584212311111111111111111112
55555632335456654765446622*144363636344453447356784367766542264335457434656633122462788647*76*7678478**666784346754336326*34311111112211111111111*11*7
6758*75453767563765545643514465544554344243759655544456*67*86*4268985*2*45533223264*8876567737578867766657672446742244226715*121112*111111111111111112
3**2123765663337434*55231*465*45*66645445214*765523344*75*6756*8744784445332313443876655877552786477768758774476432552*5724521111141111111111111*11113
*4545*554*5333572234*2312352336356543344549866647533355546656777766643*42222335337*76547873575864676*6764781436712472237234661111111111111111111111122
77764423343455543444*42333*334*465433345398653665644325545322321221134*343334754667844687656775645666865*7724365337*22632*5844111111111111111111113132
123446*8333*43332344344332*344334*35455273475443754*454422*54555656644*64*44236557456786877756255677755365244742374335333444436411*1111*11**1111112123
55456686247544445*4424443324713433344*49323335575744434344*55534421144464562355557658656778646*6567674656441773*67234343333434681111111*111111*1121*23
556444777555532554444*446*6133454134314452765654765*43444*44*45444765693413657687768*6*776556348666846*66525332853246535434357841111111111111111112213
55555544243445553444355584432*63214434525654756552454425544454224546543345665588767556577376*286768365*6334264351245664552547631121*1111*1111*11112125
34445535565545533334626444315543144645556*6654644656776*2*4*4557654454647658676555666657367448666726575834272*3443657741111111211211111111121112112111
66665645756422354*76443*4537675534545555468536745757876877236675567666666577756556*6*5636653675574*7555*235825446565831111111111111111111122*111121112
43246577564444*447212*445758**644445445468217726557668*787578765763285*52476675665665762*63486683265664142875454757**1111255*6*66641211111*11121111112
443*4556*44444743*2355853466466*44644466536*455*887*88*8667785546*857*57355677455786**66668857834465843318*544734711*112952345559142111112111111111112
344*334444445534324*186464666855555433*42363467*877*8888*88867588766*664466766766756246767556664463636214783566345111137989974*9723242111111111111*111
5466555456353574423334465*765*66648*886376677767*8867678878787*763668776676764774654668675676734655632474736763562112*758434147779899411111111*1111111
44454445655645333445676*6656756558*67*285765*67*88656777*678887*5787*768577756875546787672767525447*2375563564446*1178989*8*97999898931111111111111112
54**4565*435342*44*6746757665587767456545766548665685688767654586767886426788676466875643*7765446622474353652444711*9978788999997979921111*111*1111111
32578789765343*53456485266636877774566545646566*5575667665655886777753137*7*665467676552757*55263314672*3*65454571149924899689997868921111111111*11111
9845552467*43444*45567676537676874678746545764468566666756547756834433*768666643*566664*67665345123*845*4386554671134219759399999558911111111111111111
*686*74574442355557785684*6566457877672256435*7667676666763557755333688634448565555542853764431245684*73377367677122269999548987946481*11111111*111111
6*583*6855524365868858627*566678877664355755675766655668652456432555785264557536455*345346334*2355544473665366772111*999999988857163811*11111111111113
5*56645644344656775667866567877877777677268*57545556784564765*4457*7346444642444554444*5444414655465485788332111111299999999989913535111111111*1111112
66654**4343*5557556676756687748877766677384565455679654743433*35576745*4565235464*45554444434555337667*6641111111112*9999998799912444*1111*1111111*111
7665554679485635486785576734487778*5566347666676646454544567555667885247876545786445564*366566565778843*12111121*126999999*7599831*421111111111111131*
5*4437887555745678776466767393888435*6456667776**645443568774577754425676*52675544*654*34875655***831111111121*12*4799999987597*1223211222211141212112
446864435664**56*46667*766872444277666657777455675577*87755676755546767752565454765444677653532223111111221131231314999999969853*413*121*1111111111111
785346*7543385752655566667*3353215*65556677668885568887*6647567566678564*5656554*6454*785523312223111111311121211213999999967941311311111111*111111112
645567*352586574565*6747882143*136657754765677*5587886664667*6544*88643356665534655445872334223541112311211*11111112999999*5784111111112121111*1112222
444444556864855676454488114425216777226577454357766*544*475454478854*355657343875867642233311211121221111311111*111299999964674111241*7342344445321115
4535567686*64565867*5884*2323246797245578444445665535656*4554577755745567544385642*311122312121111231211122211111113979999354752121411432143*463212114
55356844432677*677586*1323844686433678245434777754555577876578876545574255332311221222344211231111111111111122211112322*49221852111*1231442234111123*2
444555434788*556*68614225*514754334663*444677554221111112457765666564*213332121222322424211122111*1111*111111131111321157915122287221234432253*2224421
532556878686569668348245224552433544764587*21122212332222111235895222222222343463*32*221221121111221111111231121331517*3881932421112224123322215345**2
*2456*8885648*568268567234532434453*33575112222212544333*221112972222**232444365243311*121122111121111111112111242*71993961731111111213234332133222222
435666566387865822736722532153322*53*77*111*1111356332221211111422*3244234*433524211*1122113211111*111112211*113*126263194152122111*7222333212333*1232
36775875524437312287232*6885348845751122113331352111221*121211221244444*444435*22*11111111421111511111*123*1131414121111914611297411991244222333223333
15667724253375*21367*1278774786*6741111122222264541122222221111111243544444442332111111111**121131121111321154241922121181541179*973891111123422334**2
61882343443642345778167768*26*5521*121*1221226112211223322*32222221123444544**222111111112211123321111222115234239112212112114967*323318*11252233232*3
94*234454566224578*915684223532111112222111252222133*22221*223*222111242632422222121111112111142111111111133343349111112111114975412241931124123322123
7*24433484245468412618623333*1111322222222432223351*3*21111111222111111*3343332*12111133222112232232111215323333161111*12122116914134428121122*3211132
12144455444555*112381524*2411122223222*2222123524434*21222121*11211112145332412*1411113641222232322*2322*523452411111122111112161412221611112244211222
34164544445*77331*791243551125232422223241*12443444411212322122*12*1121223121121221122751112323422423322522453241111111111**112214312112332*3*43212214
21125444544*424*68633*531122122241223222328622323222*223322222431111221121243*13411112112333243332232232223522323322111111661112111111*123214*13222252
36*134*542532325852**241**11222332142222263222222342232121121122411111111121111111211111233434222232123223332332423521*1111111*11113541167123233222335
124813455*43565322341212222323332*422332412*221422213523222111111211321122232*241222222222233333442222223232*324*2422543*4*111113634222111123242331321
23477185586675223447122322*22333352*322423323342234222*321112112*11321122232225423332222223333344**221323232223*33322*2223111111*3332*21111*232*232212
33757538675358745552133233253344314224*232224133631422122*21111311112*3244224322342222323323*24312**223424223242*5226251342611113442522311111422323222
1545681565217746821*143223262474222233335232323443222234222212121*123242422432224*22332352333343225123*2332322424323643233183112541*4218*1111233322232
125669134222*46711121**32254233232224427323*134332132*21121211111*222333222323234222332433434433*3512422423335232224*612531961*44424231761111*3323222*
55*67631346156312122122443423333222374*343225*322221*3221221121*132242*2323*22*2353233435333423232224123233212443264**362336942151443226722113*3222213
571666427*825*111214*6242242433323286234421344*22323222114221311223*324*233*2332433322334334323422333233233*243343524345334582113341322473313322*222*2
585457314*4*11122*7*26122123323422522343224*41232*23423422221222*6522422434*33333333333324322342322323*233124222431*544434*3826*12*3235185313222222222
*121582223311212364216123543323333*3234225442322222321113132112*3822382333334433232344552423*2323431*22343143224*24625***4428181*532445183*122222152*2
9721781112*12133324*1*1454222434*121222234225222222135**222122243322612253233432*23*22323322331243222*3221242*23234224*15431833211*254218432123222222*
1112982111111252436*1717422243434322*222231552223213621231212334423442*3*132*4233245232333223212322222*22223243315213632523147422125322184*41212222222
31478631211355233232161*323232443321*222214312222*5*11*21222435523432*33223333333332532*4323*22411322522132122442512*324*22147*31*32224185361282222212
111256*112334*32*33*1*2332243243332243211323213243322121312335742342325122343232342232*112332133*2222*122212344534136*2621*1563122422241682*21*2221123
12*11142144234237*3616122224243233*4431134332332322212123253454225124*62233532323425122511332222341142222221344452352125124265313232233*182*1*12222132
4111*1111333234523332624*3332332432211223322431222211*2354*55222434234*54453323452424421211*1223232242121232212645422573236*24423325633161451121222211
621*121124233365335416243443*33442321232422321342*113433413411224213348974*22654421643*311*111362324231111234*169534623*345231214335745162*41111111111
42112222324234153323253234333233442332223*36*511112844312*43233423216312227622222251221553111122221135321111258437971122132182133211111159412554531225
53221233533344353232*6224624343434223223521431222*3733*264112352351241224792342221421284*14631153113861*33115721685**576221193*31122221237332544233154
65311554423343233*3325*433343432223*2234222111245432336712234532411131381124216732*2885136115841128212971211531183111512111181363*32122131111122223344
3211112214322232444**733333223242434534221111243322248312*546412124221922224177412436*2183114612144224212931441152214423111*91333321223191111222211122
1111111114*3334355421532253252334*221112212235222224*3223543*2122221215122224*411212*424*11243224512*71135123311313*3433111681*3331*434*91113452222111
542443222111222533332541*1221123212212212222222*5542123433323412*211221212225111121132221111221331217*1421421111*33222311155713412*1111191123333434333
21333222111143232223*64122221222*22234223322**3544313533322345121112112122122121131122111111*2132121611621212111*3231122427841221322311251343444442233
3331122*224334223*33165121211112223222222233243*23222232222268212121212221221*221*111111111112*1112222*32121111266432119*1861111314512148133212111*125
331*122223356432233*1661225*45553222222233423367552*2*434223661211231111*1121121111111122*1112*2*1113111322111137653111311641111*242151121331111122126
221121222322112342*216612122*11122**43344*53232222345*2223322433511212221212112*21*113111111111211114111423321221*2211213432211112151*9862465343123211
113*23114212222323*51651112157322244454462*121346554332327135331212112111*211123*32268211111111111113211122122222256111111111211113911*4112443331343*1
1681*468522*33244324175221*68776**544653324666777642434365*53223*212222211221*122324743231111111111*43112122*21121561112111311223278136422**2231233344
334*465412222323722415524555446565534447*223234233*534344142*42224433423341232346*766566356535*6215452326543222423*223454*357664111*124211111124431125
52556443*22223273312*65233816756554332336346543333333346523332237211222411354423657787*5*24555553341122233233212211122212234553111134455421132111112*3
366312237422213*2*22155322415325622233454223363**23631642543*23424631232665*6*661*422233466522223*231633232*1133223325*556756341*111111111111123324322
7842*25734*32142222137532222426421*344533221543*224*41632252113*26211235556627684132332576546753321253212233*561234566*4654455421*36654211111114545432
45211521146421245322555412295458231323333*46214154321714214411222112242342155*5227333231233467652227322121*21134422111221111*135655322111211411122*532
232114222531*753*2215*5421662688633344432245132*5271141421*11242*112312331473413773312353244776763231221**121142212231121112431135*3*2112331211111131*
1221222154156431241145542192425236324444324316123252112311111131212211421*5351377724785524567545621121212*123332*278874*111226432125211378661111111121
2121122341*221766311755444*718221214323212232512622121111111121111121221123311631124221154214411372122122128342234775554532111135*11122421117311112111
112122122332245331124676345776228784654*1211252111112121111111112111111111311242112*221*422343422212112252242213755213455311211146*1112111313711111111
34223355322121113123421111648142112112442233213334232422333422112132111111111111111122123246721211211122212211122136554544412212112133116655362111111*
*11111112431426*522162211215744111211142*222322237242523234233411*221111111*1111111111113*6*22112212446421221113213564441211123562*1322273112111111112
*556*1262122212222112114212661121212242525*76422221*22324451221442221*111111211*111111221532*11112*21111212242221143331*65212454111131155111*114321112
2412243521212332*23151141124212221114642*31232132275*33333332232361221*2111121111111*2121231*1122384221121*21121223*42654365231111114*333221*551211113
111111232371121113214*131112112*1211445112464242222313343*33222322*23221111*111111111111111111211*223642321212211212271444415222111111*21244533*531222
2212*22411651122343241111112211223111241214366422222*4*22212112311111*2211*11*1112111111121121112113453*41211121221154466***31111211**2212381122321412
4432334611572124*2213*1112132332213111221521254222*65*33333244336522212211111111111111111121111142242233432143*1221173414*13*1221111111114521131222132
111**312111554212*422122111412223434111212555132222346214*44333*731113234333311133*3111112222124**241532218775*221252511525413434211111112221311223224
2357652111*76521*51212421115112222232112346452331122*2125446532172111232332221112464221112222213213124212274222211441371312121111111111111214126*75412
776665213*11564211*5674111151*22243*111146113366132143422222221131111123311121*11321211212222221452122123311111221**12411498431*2111111112122125333372
*66766215411655213445761221614111232211182132*214726712*233342222*11117664221121112111212222222132114112221*12521211114151811**12*1114287521135*111111
44555511453146641344*6412322135213111211426812312213111112211111131272655*2256111111*111122112111111111121142342211121*5122311111117422121221111211111
54*4411155**35551345*721114113544322451134741221121*11111423111111112155361135121111111112111111221121121136442*111*1114112111113125121122222*11111113
54545125533*13651445471111411135654434113641*3111*11112112133322*122312146111*111221111111112111111121122154311112124111221114677141*12*23*3*2*1376213
54451143*21421351556*7111121124*4897454114122211111321*111122121222111254*3245676*3*3411111*112111121111143479771244*2111118711211221233*244*22267*223
34332142111421151466561111*11112212422511***2111112111111111*1212412212344*332234444252111*1111111121113124132218777*111111712212241223421112222341121
1212134411171113155*711111*111*31234*2321*21*11112311221111111112222211211221212112112**111111111111111113114*52573121*11111232221*111111111*1*11111*1
2511154411162111165461111*31312465622111132131111121*2*1121*12122111112675754434455*44*1111111*1*11111112111741131111111111121211111111111111111111111
564115751113551143252221*1415112212464421111221111111114773123222224*11655555455423354211111111111111111112*12*1241242111*1111111111111111111111111111
65511475111355111124423111415116632564321111221111111214543*462252*751168888776788666*111*11111111111111211*2221222421111111113211111111*1111111111111
*55115741*1*4541154212311131511*244411111111112111111312235123124145311212356745444542111111*1*111111111211211111532111111111111111111111111*11111*111
55712763111145413265*2311122631211121111*111*111111114364541455655343211111111*11111111121112*2211111111111111122211111111111111111112112111*111111111
6*7*15741111553134652231111361*11111111111111211111114454*613234433421111111121111111111112*131112111111111112122111*11111111111111111*111111111111111
*45122111111655136*6222*1113511122221111*111111111211237131321111322211532*21233213212*5521111111111111131*112112*1111112111111111111112111*11111111*1
763221111211236136672233121*6211*112*1111111111111121336*2211133434331144*14562236341216*5*112323221111161111111311111111*1111111121111111111111111111
12*11*1112111151257*2224431251112112113*111111112212421*21111111111*11*11114445425*4655342113212212*21114111111111111113123444344434*41223441511111111
1111112311211251*5763234431122111122112111111*1111223111212111111*1**1122116554*26433423521111*22223311111111111111111291531122323*42*12111212*1221111
11111131112*112**57721*4342221112151112221111111111121122223111111*11111*116522225341112431111112*22211111111111111114232*3331223343332112222232331111
124312122*1221121421111121141311223566421111221111111111111111111111111111121412442*22336411**21112122111111222121111211112223233111234**333334*3*22*1
333212111212113212122111853344*245312111111111111111111*211111**1111111*112132111311*11*231166466666561122111111111113111212121111111265814*1111111112
111122233222321212212111123422222222242111111111111*11111*111111121111111*1515433121111112115466445*57211112111*11111222114211112141111212442211122211
1211111111111122112213113111121211112411111111111111111132111111122**21*11222232111111*11211655666**751*111111111122111*212111*36767111111111111111111
2223*11433443321*2111112123345545533411111211111121111*1111*1127634*3*32322221223*2*32221111111111111111123334442432233412*1*4777631111111111113211116
2*213126455467554532211323322332*233211111121111111111*1121111121112112*441222232321112211112*111111112127421122222*223231121376*111111111111112*33135
114321243*23334344442131232121112222111211111212111121111211*1311233224121122624321111121133576544554*11277711114666677411*2*21122*11111*1111123214444
2332214*45554554454411531223*433*322111111*112121*1421**111*114222121131112154422321111311*1444554544511364*1111232423421112221122112111111*11222214*3
222122875557555555441133333233322*12111*111111172*3422111*11112223221234112*2131*21121121121255544534411*26*11112*133131111*11111221111111111111121134
1111111*21244123211111*11111111111222112321121141325211111*1*1122112111113242322121124222111127*76544511212111112132446212*111112355421112111111*22122
1111122122233*23111111111114111111*12111211141141211111111111111312*11111122122411132*2*22111145433544111121111122734653111111113463221121111113451111
1*2215423451346457771*11*234331354712112111*1*11111112111211111*1211222211*13223312222223311112222234*11211111111223233111111111111232111*951331111113
112124532223223224551111323432124**132111111111111111111121212111111*3231121111211*222213212123234445511211111111*22255111111111123111111322422*11*112
11111221*11122*4222111112*3411*2553121122423321211112312223*32111111121124222111111*222322221111111111111111111131211543111112111111*21121111211442111
212243322111111111111*1112351213546121131323322*221323343142211211121211*13*211*11222232121112311111111111111111111111*31111112*1111111111112112442121
646*354411*1121*111211111234*213437111141333212222*4*153214211121*1*1212133111111122*32211112211111111111111*1111*1111121111112211**1111111112121*1121
*211111222*112342121*1241125131342421*222263224232*22*5112*1*13231*1122211111111111*221121111111111125111*1*1*1111111224*111111111112257*1434111111111
562214*432111123223*3116112523234*6211322252**512152133113211*332111111111*11211116*2**11111111421*1242424211121111111222121111111*2323111*12111111111
42222211111212121121211711412112313111423411231223422312141111332211111211112143*111551122111211121115533344444565545345111111111211211111111112111152
32322*22122111*2334361171151111122211222*511231223*2331113111133223211112121434311112*111111*11111111133*222221221111121211121121211113212111111135311
3523*56553363543413*5117116*11111131351133122211342131*22212143121123412433*14331111111111112111111112133355433*33332312214111111111111111111112211111
2333121221111112*1212116*141111*1221441***2232315422322132111111**43**1411*215121111*1121*1121221111133*3224334544342225332111112111211211111111111111
11211111*2122212113241171131111112112*116122313164222*1121121114*643334311522312121111111111112111111*222111122222232143441*1*1121221111111*2111111111
564582635373223211112113113111111*151233312121224224*21231143463*3*3353214115111151*11223*2112211111122222222112111112221111124211113211111112*1*13111
333122122432224352311211112111111225*22521221133422331122134111346322631351241111411111411112121111213222421332*111112221111*21111111112111111121*2111
125433*22*2112*223212111111111112411*314131221141133*12311314311*312442253141211144111121111*1112214111132211122111111*11111111111114421132111**1*1111
787*244445647655335221112111111113221322132222151221*13123**32214211431441151*1113413221*2121111211211*111111111111*121111111111111111*112111111111112
22221111212334443565721113241111111*112*111112112122131133133125*23551152232111122414211221*1121122*1*111111111*111111111111111111111111*1112122*11111
111111*243*433345*5322111*1211111111234111111*112111141142151134112*312512421111414*52111111111111211111111*111111111*111*11111111111111212111111111*1
56434321213*22234244631*21*11111111111111111*111111*2211523412441143126222422111413*421221111111114111111111111111111111111111111111111221211211111311
111111323232332233313211111111111322211133222222*1233145*5748734174535443444222331222211*1111211111223111111111111111111111111111111111111111111111111
3332111121112*2221211211111111111333*211333222211123*14446*7875323344523443411233*122211111113211115112*111111111*11111111111111111111111111**11111111
343*3443323443213222332111111111133331112332231111*3124232111111111111111112112431132211112111212321112111*111111111111111111111*111111111113553211111
232*2111241222221222121111111111234331112333*2211223111*1121111111*11111121211132112*21111111111*211123*111121211*1111111111111111111111111142*11111*1
3343*2213221322222222*221122411113424111544*344111451322111211112122222342321*133*1233111111133*111111111212111111122222111111211*23111111112136121121
1*232322*221111121322121*131311**4445211555556411*4*13332211112222*222*131321112312*441*1111*111111111112424321111112343121211221123211112111125144112
