3*14333*434314*
3141*232241*241
2*1214141222423
4123*11*114*444
242*24444*24341
1224423**22*311
31241242*3234*4
314431134*11121
1144321322244*4
4*4241122413*41
21121*1*344242*
2421*2423*12324
44234*421*43143
*44211*123414*1
412333131432312
