6*6666666*665554444444444*5544455558*888*7877677*77*7*7555**544443444343444
6666666666664565444444*4555*544*555888888887*67*76777775**55*34444*33344*44
666666*666665554444*4444444444*55*68887777776777777*77765*5553444*3434*4333
76666766667674564444444*4455444554588777777777677767777655*553*44*3*344*433
656666677776*55*4444*44*44444444555*887777778667*76**777555554554433344*333
666666777*7*7655634444444454444455*788887777767777677*775555*55654323**4*33
566*66*77776664554*444444444*444555588*88878*77*7767777755555466554*34*3333
76*6677777777655554**444*4444*4455568888888888667767*7776555545655333343333
6566677*77*776*4*54444444*4444444*46877777*7887**767777*6*55546655232234333
6*6566777777*7755*544444444*44444555*8777777777677*7777*655554666533*332333
564*667*77*777665*5544444444544444555777*7**7777*777777775555*5562333332233
76*66677777777764555444*444444444555588777777777676777777555544563333*333*3
776556677*7777767*5545*334444444*45558**7777777776777777765554*53333333333*
77566**7777777776445554*654*4444445447*877777877*77777777555*44433*3**33323
777565*7*77777777545555*5555444*44545487*777778*77667777765*5444*33444333*3
677755666*7777777645555*55*55444444455877777*7*7776766777655*4*43*4*44*433*
666*755667777777*64555*55555*554*445558*7*7777777*7767777655545333444444*33
6666775666777*7777445*5*5*55*4*54*554477787**7*77787767776555453334444*4433
*6*666656667*7777**4454555544*44445545588*78*888887876677755544333344445533
666*56665*677**7**7444455544444*4*555*688**88777888*86677755544333*44455543
66666*66566*7777766644*44554*4*44444554788887777778*8766*755545333344445443
66*66666*6666*6667666444444444444444545588887777*7*878*67*65544*3*333344333
6666666*6*6*6666666**44**444444444**55558*88777*777787*6776**5*3333*4444434
66*66666666*6666666666444444444444444455**8*777*777778866765*443333*4443344
66667676676665666666664344444444444444444*887*77777777786*65544333344444445
666666667666665666*6*66444444*44444*44455888777887*77777766*544333344*4*454
66666666666666*6**6666*644**444444444444588877*777877777766654443344*444444
66666676666*66666666666654444444*44444**4588788787787777777*554444444444455
666676766666666666666666*4444444444444*444888*887777877777665544444*44*4555
666676666666*66666666666664444*44444444*559888878*77787778575544*4544445555
676*66666666*6*666666*66666*3444444*44*4*4488888**77777777766544445*4445555
66666666666666666675*66666*5344444*44444444998*78*88*777777*654544544*55654
666666666**6*66*66*6666666665344444444*4*457988*88*88877778565554*54*366554
66*6666666*6*66666666**6666*6534*44*4444445*98888***88**7777*5544454*46*644
*6*666666666666666*66666655*555334*344444454988888**8887778856544*544456554
666666666*66666666666566*6666555*34*444444445**888888888788866554554*455544
*666666666666*6*666666*66666*6*5*4**33344**5599888888*888778*6555544*455434
6566666666666*6666666666666666*5555333333*5*56988888*8888*778565*44*4445444
665666666*6666666666*666*6666655555565*555555499888888*8887777655445445534*
6565666*66666666676*66666666666555555*5*555*55699888888**8777765*45544554*4
6656656666666666666666666666666655555*5*555555499888888*778677565*554454444
*6665666666*66666666*66*666*6*665555555555*55547*88*88888877777665554553443
777*66556666666666*6*66666*666*665*55555555555*6*98888888**777756*4*4464443
66777*5*56665666*6*6666*66666*56***55555555*545579888*88888*767766554*64344
666676*6655*65666**6666666666*665664545555555554678888888899777766555464**4
5566666*6*6*5556666*6*66666656666665545554555555678988888*99*8766*555455334
5555566666666*56566666*6*6656666*6**664454545555456*88888*99996676655464343
65*555*566666*65666*6656666*666666556665544555555678888888889*9676665*64444
777777776555566*66566656666666*666566656665555665*56888888999999666655*4644
*777777777775556*6*656*5666666666666665565566666566788888888999976666564635
77*77*77777*7777*566*655566566*6566656655*66656655*6688*888*8889866665545*5
777*777*77777*7777656**65555*6665665666556666555556*6688888*88889866*5445*5
77777*767*77777767777656655556*6555*6666**666655556567788888888889766*45545
*7777777*6777*66666**6666666555556555555656*656556666677888888888*866656655
777777766*67666666666666666665555555**555*66*566*66**666788888*888996665*55
777777*66666*6665556666*666666554*555*555556655556*67776777788*88*897664655
***66666*655*56665666*5566*666565555*55555*6555556666666***7778888888555554
666666555*5665*55677898887765566*55555555555555566*6*66*6777778888888965564
*56*555556655568888888888*88*9865*65555555555555666657667777778**8888855464
555554*6555688*888*88888888888888*765555555555566666667*7777777787888*95555
5555566***8*8888878*888*8888888777*7766*5555*6566*5566*666*7777777*788*5*45
4556665578888888*78**8888*888*8777*7776655555666**5666*6666777777*77888854*
566654577*8*777888777788*88888*7*7766*66665556*5666666*667*667767777778*654
6665*5778888*7787*777787777887777666*55556*5555665*666*66666676677777*88*5*
65*556777777777777777777777787*6*6*565777778655566*66*6666*6666667777777865
554567777777777777777777*777**666*5487777579998555666666666*666676*67677764
5555577777777777*777777777777666**5*7777569999*8*566666*6666666666766667*67
5544777777777777777667777777766*5577777**998999*9456666666666*6666666666666
555577777777777777776666*777656557*7*7*56**9999999546666666666*6*6*66666666
*5557777777777777766666667776655477*776489899999999456666666*6*66*666666*66
55557*77777*77777676**6*6*766554777776549998999999995*666*66666666666666666
54557777777777*776666666666655567777**4599888*99999975467665566666*66666666
545*77777777777776666**66666544777776647998888**99998445*666666**6666666666
5*55**77777777777*666566**6555677776664899*89889999998555666666666666665666
5*45777777*7777777*66**66655*47*777665*999999889*999996554666666*666566*566
