322222231433333346276826846664444*555*55**5*55555555**55*55*55*5555*555544*
3232*2234744223*3*51556332454455*555555*5*555*5555555*5555*5555555555555444
222*2234456746432453356*23456*45*55*5*555555*5*555555555555555*555555555555
4**1234*676821327346*733*4344455555*5*5555*555*555555555555555*555555555***
76*123641*5465642143*52535764*55555*55555555*555555*5555555*55555555*55555*
852*4444367*68677413757644*64555*5555555*5555555*5555555555**55555555555555
**9**7767443*74*32727717*64545555*555555*55*5555*5555*5*555**5555555*55555*
8*63998*4444*224*57*53444*55555555*555555555555*5*5555555*555555555555555*5
44426244555444443334455555555555555*555*5**5*555**55*5*55555*55*5555555*5**
4444**55555544*444555555*555555*5*555*5*555**5555555555*555555*5*5*55555554
4444455*55**5445555555*55555555555*555*55555*555*55*555*55555555555555**554
445*555*555*54555555555555*555555555555555*5555*5***5*55555555555555**5*555
5555*5555555555555555555555**55*5555555555555***5**555555555**555555*5555**
5555555555555*555555*555*55555555*555555*555555555*5555555555*5*55555555554
5555*555*555555555*55555555*555555*5*55555555555**5*5555*5555*55*55555*5*54
55*555555*5*555544444455*555555*555555555**5*5*555555555555555*5555**55555*
5*5*55*55*55*44444*4*4455555555555555555*5555*5555555**555*5555555555555548
555*55555555444425*2444555555555555555*55*555*5555*5*555555555*555555*55646
55555555555*443357*5*4445*555*5555*555555555555**55*555555*55555555555*4*37
*555*55555*444335*7*4*4444*4445555*555555*555*555555*5555555555555555*78*6*
555555*5555444*2227337*8334*4445*5*5555555*5555555*5555555555555*5**44*7385
5555555*55*44*56566767575657**455*55*55555555555*555555555*55555*544463*7*6
55555555554*444356756767665724*455555555*5555*555*55555555*5*5555*4464377*7
55555555***544*355*47567585*2444*5*5555555*55555555555*5555*55*554444437*67
5555555555544442775*4764*9765*445**555555555555555555*5555*5555554444436636
55555555555444*476575434*7667244*555*55555*5555555*55555555*5555554445***56
*5555555**5555**3556*412*34874*45555555555555555*55555555*5*555*55442744*87
555*5*55*5555*5446*658*77673344455*55555555*55*5555555555555555*4444366*877
555555555*5555555*4864*6*23444455555*555**555555555*55555555555444***8**888
55555555555555*5555544444*44*555**55*55*5555555*5**555555555555*54426*48678
5555*5*555555555*55*5555555555555555*555555555555**5555555555555444277*7777
55*5*5*5*555555*5*5555*55***55555*555555555555555555*5555555554444336738677
5555555*555555555555555555555555555555555555555555*5555555*54444445766*6787
*55555555*5555*555555555**55**5555555555555555555555*555555544444*6776576*7
55555555555*55555555*555555*55555555555*55**55*5555*55555*55*44446777*7*68*
555555555*5555555**5555555555555555*555555*5555*555*5*5555*44*4457677*77887
555555*5***5*555*5555*5555555555555555555**55*555555*5555554445377*6*787767
55555555*55555555555555**5555555*5*44*5555*55*55555555555*444*67537*7777878
555555555555555*5*555555555555555***644*5555555555555***54443467*6776778667
5*55*5555555555555*55*55*55*555555**444455*55**5555*555544367765*677688*6*7
555**555555*555555***5555555555*5*444*45555*5555*5555*444278754765878778777
5*5555555555555555555555*5*55555555**45555555555555555443566**6**768568786*
55555*5**555**555555*55555555555555*455555*55544444*5*43*76*5*7756666887667
5555555555555555**5555*5555555555*555555555554444*4555447658688767867767787
555555555*55555*5555**555*5555555555*55*5554*444444***43*7788776*7587888778
555555*5555*5555555555*555555555*555555*544*4*44*44*45434665847887778*784**
5**5555555555*55555*5555555555*55555*5544443644444*4444*6*64467*78*57**5856
555*555555555*5555555555*555*5*555*5*4444443544*44*4444567*66*887**77*77764
5555**5555555*555*5**5555*555*5*5**444444443**444444444444467*6777658*87876
5555*555*55555555*545555555555555*4444*44344*4*444444444655776*8786*7677768
**55555**555555555445555555*554444444*434444*444444444*37867*8886*5*6777787
55*55555*55555555*455555555554444***8323444*444444*44444***7877884*76732**6
5555*55555**55*545555*5*555544*36534777*344444444444*4445778*787**477552***
55*5555*555*55555*55555555554*45325*784344444444444444445*78787*433662*3747
5555*55*555555*5555555*555*544346667682333*44*4444*444*43688876544376456545
555555555*55**5555*55555555544443777**7745444*4*44444444**678455544777*68**
555*5*5*55*55*55555*55555555444**28768*76744444444*444*44444454444445776676
5*55**5555*555555555555555544*44676787778*44444444443444444444444*327*7788*
55*55555555*555555*55*555*544443*376*87*444444444**4344*4*444333*6533667767
*555555555555555*555*5555544*4443*7785624**4444*4*44344*3*3***4*53**46**677
*555**5*55*555555*5555555*434335*7376532344444444**444443333374562*43377776
555*5555555555*5555555554**46*43*42768*83344444*444434443333365*5633336*778
55555555555**555555*55*4435766673**668875*444444444*343433333557653*3**7742
*5*5555*5555555555*54447424777*84**7*7776344*4444*343333333335**5**6*75682*
555555*55555554***44443*586***554*3335777*44444**33333**43*34566*5356246644
555*5*55*555*5455*44433666*66656434*67685*4444*33333333333*33*66552564333*5
5555*5555*555*5*54444*576*56662*34335*78***34*333*33*34333333366633*443*344
5**5555555555555544*4443*7566634434435675*7333333333333333**34*554355334333
*555*555555555555444443*75566633*33435*76554333*34333333*333*35644*33**5433
555555*55555*55555443456**67*834344466676*643333333*333333333347**337555635
5555*55*5*55555*5*44*7776576*3343878*67*65*433333*33333333*43**55456*557566
55**5555*5555555*54*877*7*7*7344*3775688***43333*333*344445*3565*6556575664
5555555*5555**5555443**653444444*376*5654**35633***33445655665657*565*66*45
55*5*5*5*55*55555*44433444*444*6*687677567655643*33*3*466*55555666*5364*7*6
555555555**5*55555444*4*444444355768856*665*453333*33645655655656*656455***
