1133232323232111112122222
1313112223331122331332121
1332312313*13322331*21333
*211213312233313322211232
2132112331223113133123212
1132223122*23*121222*2232
11322231323233323*11322*2
3323333313312133213123322
2*31221222321322111212311
2322222113333111213121223
2**312*211223213131221131
33*3211323*21133113112112
11213111331331211*2212212
312*3323*1*23111112111333
3233121322*2233*3*1213111
322*2312211231112*2221323
1133*12323132321121232312
13133332133233121*2*12133
2112322332111111332321221
1232332112232222312113113
3211112133321123113213111
2321231331333223123313132
1*23323332321111131333312
3221*321211312312111332*3
12222112211113213*2113211
