6754**334554*5*6565**456556*66666***7666666765646565555755567*6*6566*546*6777*44**66663345756554444*
45465*543445446556*546655546*6*565655765*65*65554556**56646676676566*67*55865766685655455445566544*4
666455*556555655555545454564565465776655655555665*33655*55666*7567666667**677*87666565*44*4545355444
665554574565466667754***5654*4565546555666666555656755456566665567*55766667*666666455555545545464544
667563564555545*67*4555665556656457876665*5555555*6766432*5555*5755*56776865666664545664566767*66554
66563444654555556757645767666*56547576554655*56556676577*65666*6655556665756655564565446334444*45464
76857*64545*56*566*54666656655*5575455*6665666656566666*6555*76655665*556666563556555565334444545454
688877*6676656*7565*6676*6677655665666665564666565646555566667656555555585665445656666555444556*6444
*7*57775*64666687655667745666677656656566666666666666665*56456675*65656667634*5666555563653355546555
656666678754675466667**67555685766766666666667565575*567466665674365*67676333**555565546444564365574
6544567*66745687777767766*7776457656*766766566*6657*666*655756*44456*677343455555555556**44487476544
5767557536367*87*777*7877786757764656678667676767566666*55*655454*57565233344355565554*44*5676855555
776677675577867876778677778877765666*4*66664656776666555655555455*56*4433333355*655556454*75866*7**4
777786777*776754668786687786787675664654*66**6*676667776555555555555543*333344*5*5555544585766*66*45
567677686587768977888885677687878777876555658865576666655*45645555543333*333*656*5456*54466556*55655
777676453778888887786675456*68888877766665566674566666556456245**4433333*334465555554555456766546665
7558665666466778*66765645554776777888676*6566775*66666*544445454433333333*334656554554665*6767*57*75
886877755755467866*75645565568667677*66766657667656555434444545544433432*745*556667*77666777*767667*
8788684445555546757854*5665585776786*8766*7746*6664557334444432545*542247444*66*887*7776777776637855
55677*48545456*67855455565577578*67877*8*777646667*63433333*4*356445446654455555777877877778545*8777
7777*8644545466485545555655686777667*778657*866665**5333334444655446674555*555*555555*8778766878787*
788888877555*5655753555544578786676868787787766765654333444*4444445695555555*555555*555877877878*876
7747*7854*577554565455*548*7678677688887767*6664*45433344*444444*4785555555555555555*555533377767887
65957776757835*4555555555677787575878**788866*6655*533*44444454*4666*55555555555555***55555554687*57
68777777666367534555545*5587*8876578768486755556546533344445**5555*55555*5555555*55555*5**5555556667
6886547667567*64455*454*667766877786*64688755*45445544444555*55555555*5555555555555555555555555*6688
5777777557*6666455545*456766*5765767868*7785554674563444455555*5*5555555*55555555555*555555555546776
887777666557766455545556656777778*878978*85545*685333444555555*5555*555555555555*555555555*5*554*776
*6758776684457545555555*46768*6788*7787**6555535*44444445**55*5555555555*555555555555555555555527778
6*757557666755544*555*5558768888777777666*55555663*4444*555555555555555555555*5555*55555555555467876
787676857*68864546544556*787876776576665555*55*556444455*555555555555555555555555555555555555477*755
7867677757887855588756664648677*66565*666656*4555*44455*555**5555*5555555555555555*55*55555556758456
258776*77655*8646*5*4*5473488666767555554*45466567445*555*555555*555**555555555555555555543*66*84663
33*6*77*8666668765566765*7776**655*454656456466666455*555555*5555555555555*555*55555555465*667856647
2*58777886677787*77**6566766*5354*5546664*666667545555*5555**55*55555*336643*54444554336686667455874
3*3658788*778778*76**7866587553446475666565786763455555*55555555*555667676**77556676867656*484584789
*334478677585877888*77675677656575454546*4787*68645555555*55555555577*46876865667666756868**64474766
33246664587*76768775*6656*5876776776657767677666345555555*55555556676637676**4475766559*64455*848777
4*333*4686767668778766867*84677*867657766877676434*5555555555555566488*757574356**56*66*85684*668845
3*33**467577675676768887768566*677676788868675577*555555*55555566688678*7557*8679*7*7*7485636668478*
44344434456*7477857865*876775*686457886885455657*845**5*5555556666866755*8457*73**578446543958876456
*4444443353*7556*766779867775778886*86556444*757*73455555545536***665778646783585567648*8475*6944477
344444434423467**6*67*7664547*7857*644446576745457764444*56768694367778*7644464548446775656522738*44
3344*4434*4*4446866**866*6867686576676778*6863465457575*66866578765563645265553568465546674432575565
4*444344445555552546764886**68566788**8886*65544476443433466685*4857768963548356*34344545665*8775567
553343444455555544366887876855877664887868764364755*444465*6*678532937438654433463636435*5323574*531
6452223344555555*44266876685*48458467*7*4438356*84444323865773566*437774553234553974679*4367544*5745
7565534*345*55555542577*8665858765777*64*22274*7248385638574595*4256456*6767466834385764445774547968
*88744624*45555*554355866772486568447626444442756452*475777*4**54635447*54423454*43576*6347672457745
766664443344555*55435748*47*8867655623455544374687*54*6354666*555542375245454473*46*465867864366**54
866648*3454445*5555*6674766648543469665555563265*55*767754565*584332357322*4*64445546745*544*7545443
446658736**45444555*5555785645592243655546444337873575*785245666**435373*2125*367877777574456464441*
545778763667*8*44554*55778865*8722475555444*33*2369453555957655*344622543233635786776685765535444114
554348557674455455554787677*8678524555*555*44363583648775484734485*63752343812767865*668754544452564
55547657665*555*445*537568786654764*5555*55447533456488583253378855558544652*4758*6468*7*45*46652*33
555548776*455555555554647*57*5546575*54555544443*38385555827*68636454*54352*658775573555835674432313
555**547694455*5**5*557**76877*4654*444*5555444423884566666243*3664337436412*78745442434855323442116
5555555564455555555555555676688578464455555556534455634*858628456555634564*577823444*847344622331157
55555*5556876555555555555433766*4473568455*555558667798*6555745486474564*557382444*4447344512341357*
555555554667655555555555554*68666775742545*5555*54*445435353*486*566676557646645555545*45321*321426*
5555555545855*5555555555554457*54486676264555**5564455846663474*844566765667755555555444623222218751
5555555545555555*555555*55*32335553854444455555444356556857586*88555555*7*84555555555547446326757221
*555555566755555555*55555564*65567552345544554554432336453*7464785***555575555556*555546443376822311
555555546855555555555*5555545665*75*4444444444455*4433345554554875555555*55555*8555*5547743444252113
55*464738555555555555*5555*55*6574526555554448455545454555555785555555555555546555555*5*443431531142
455686555555555555*55555*555554768734555555**455555555445*5*555555*555555556433555555553433126*44322
*666685*5*55555555555555555555*84*6845555555*455*55*555655555555555555555*54475*55555**4817826544221
47674655555555*55*55555*55*55556555455555555555555555*555555555*5555555555677*555555554*77745443332*
636*5755555*55555555555555**5555555*555*55*555555*5*55555555*55555555555*55555*555555554278255*211*3
443567555555*5555*555555**5*5*5555558555555555555555555555555555555555555555555555555545373237*32321
554**5*55555555555555*5*55555555*5555555555555555555555***55555*5555*5*555555555555555465762*3523221
55544455555*55555555555555555555555555*5555555555555555555*55555555555555555555555555547*74346434221
5*55555*5555**55555*55555555*55555555*5445*36*463655555555555555555555555*555555555*555657*456745511
5555555*5555555555555555*555*555555555*7666786755555*55555555555555555555555555555555536342347*43632
555*555555*5555*555555555555555555555555555555555555555555555555555*555555*55**555555577433467725431
55554455555555*55555555555555555555*55555555555555555*555555*55555555555555555555555554476313*5634*3
555555555555555555555555555*5555555555555*555*55555555555555*555555555555555555555*55444746374124442
5*5555555555555555555555555*555*55555555*55555555*55*5555555*555555555555555555**55554638*64432232*3
55555555*5555555555555555555555555*55555555555555555555555555555*555555555555*5*555554357352284133*3
555555555555555555555**5555555555555555*555555555**55555555555555555555555555555*5554433*2**4256322*
5*5555555555*5555555555*55555*55555555*5555*5555*5555555*555555555*555*55555555555543235423532343222
45555555555555*5*55555555555*55555555555555555*5555555555555555555555555444444444444*2126422**522253
455555555*555*55555555*5555555555555*55*55*55555555555*555555555555555444444444**332114*63485**34*53
55*555555555555555555555*555555555*55555555555555555*555*5555555*55544*43334433322172*11552*5**22354
*555555555555555555555555555555*55555555555555555555555555*55555*55*44345545*322114123187**853222233
555*55555*55555555555555555555555*3464*555555555555*55555555555555544455555543111283334652444*242324
455555*555*5555555555555555555444387347445*5555555555*55555555555*44555*53565212221*221414256**32386
44455555555555555555555555554334*7*675313224442*55*55555555**555544245545554412324424223277447524436
34*445555555555*5555555555*43537524443*23332*12*44*11111245454*44433332*54611263224111326*336542245*
2334444555555555555*5555554551744342331*332222222212222*32332222*4322432344121642726122542*255*31232
65744235445555*555555555544145543*2233122222222*2222222222322222224353*2*3412662*3422236524854522344
445423423*455555555*5555*442244422222*22*32222222*2223232232374132232122*75262242324427554*667*52211
636425324444555555**55*5544*243322*3*2*2322222*22222223534433144111523216*53432*522*63446456*5546462
754*432334444555555555555544223322*32232**3123222223*33346*32*22*2*31*1533523*64222234444*36628434*4
*6531*342334444444455555554312*2*233*2*2223123333*22222333321121222124543**35*1274334336735*44335563
431*34422*2*12223344455555442333*32323222332333233223225322**2211222*76424313121*55324366655434*6744
5*7442*342222122223344444443*322*2343333333*3332232*223*3222225322**333414242117541422*455555545626*
*4243332*244*222122313444422412**22222222233332*52*373322*221421422333244413532*513443345555*554*464
6613332322233322233323422425*2222322*32*22*23222246352453321221221234245*4222*22155*6434555555554452
32*1*13313*43223223223*43*33223222222*222*222222222122132152233212332222344223322*63423355*555555546
