12321321*1313323231122213
2323131332122332313333233
332*322233313211212*3223*
*1133231323312*3312322122
3213232313211331123233313
2321232312*11121111112332
3323*33113232131221322323
32122331322*21132311113*3
*113123122221222313311112
3233233113212322331233133
2331323232332221232221332
21111313323313*222113131*
2113112112313121322113211
31*1122132131232122133213
21333331213211123*2113212
121113*13*221331213212233
*213*1*232333231233111132
1311231123121*13333121*22
1132122232*211333331*1331
31231332323231213323131*1
333211331133*112322113321
33322**231213221233323311
2*12323221*22331333112122
2311231121131111113111121
1212332133313312322323133
