*6562333335433334411134434443222*456456555568351*2111111111112111124*1121111*11111111111955855765*56*8*78876*66787768787111612*1233452*617785556768444
576633334336354316*323*464444333*13456555*5645514*1*1111111112*111141111*2111*11111111129369665777768798867675*677879884111116113*42939613547776679754
5653334433*3644*42442333564446433628*65556655632531111111111121111121111113111111111111473986856867*8887887999768788*773111118512575968422975978576886
55543434441311**2333344454454645643455456564431222211*11111113111*111112135*111111111127559847677776889866667787*7786861111137636744781772443478524489
55565434541111123345*454454*334334*1455*555453112221111111111311111111*1*34*111111111*15558848*89686878586789**77*8*6772111146476655851871211234*641*5
55542344346444433234*35564444445574*5*14*344421111111111*1111211*11111111*3*11111111121947896878976787886455586*87888*81**1125442789*58842112533447999
553433*231**43333224311245633354*5*44532*3344211111111111111*311111*11111221111111111219739878968*7687*4677666*68778756111*115621599699543*23543555777
55433333522222234332112234434432534433*34455*1111111111111111211*1111111123*111*111111181786869888669687786576877778772111111694779838417912125767*962
556243*2522222234*4*232234146343233*5533323441111121111111111211*1111*1111211*1*1111111739567788877786877665878778687*11111*1*789*7746129911441234555*
55633333263333344*23233112426434334333443334411111311111111112112*11111*11211111111111*656457698787686*765643387776869111111126963575427963116*343*555
55*331122112*45566443324332444213343443443*241111131111111111111111111112*2111*11111111755755*797*788968*6557587857*6*1111*111571468948*38522443321*11
56633112211123445622444544434242324334443233311111311111*11111111111111122311*11111111*774586**8777779477779656786787811111111364869866449631565665455
5552223312123*3331214*34434*43443153354243231111111111111111*1111111111132121111*111111454488487796869647767778878*6931111111112761756776798213*445555
45*233124311232212334123*5341*3344**233*4323**111111111111111111111*111132211111111111166455978798677886*787778787668*11111111128427988754997*37655555
556*4433121*3455444334*1113453223343*3755444*1111111111111111111111111111141111111111*11585768*8885975798784776587688111111111*185886*1127846842346652
56**334333*12355655445444324433214134*2554341111111111111111111111111111213111111111111164657777787867677986986557888112332111115*972**111782834976*66
45553233332122523322342343344443223345322344111111111111111111*11*1111113231*11113211121638663876685776578*5*88848988111111111112775997411265841431325
555644432542332224664445*6411**63412*33444*31111111111111*11111111111*11223121111111*114423956689688984798895467*9891211*11111111956456458319551*2344*
556534443234444455554322555321118334234435443111*11112111111*11111111*112121511111111*14346696498848667989998*67688*1111111111111778*87*9683*35*544454
4555221121221223*4444562334323322163433332536111111113111111111*1111111111148*1111111*115418185887977657863*788886731211111111111399679*89989431464564
45545411111232*2*25*4422*32122332226664253346211111113121*111111111111111124*1*1111113115444*657897*7877789997*758831311111111*12299853758999*115636*4
55664344*124122423543575454211232*223545434411*111*1113111111*1111111121111571111111*23*436946*8469687777897888*9871131111111*113293979638979311*55433
556423212217456546666767775421234511126443432111*11*1141*11111111111111111*471111111*131542657275556*7885499878869511311111111114194487999939321554343
455111*11*2*67656655566657*6321123512165444211*111111121111111111111111111147111111112314335981779787799974988888661121111111111418911788*81*331345568
55311211252113776555544555*2*5421224652256422111111*1111111*111111111131111491211*1*1111*1*34678658597323565756476*21311*11111112277731111371222375544
5541212345533**56766675465542245222*244226524111111111111111111*111*1121111381111*111111611458787746689976878789935134111111111113*599211*991334145577
4556544367735444334536676466652*232232334332*11111111111411*11*11111111111125111111211212144776589879*778798*8744721321112211111162746999811177611764*
555543456654**534434347776555755333222332432111111111112511111*1111111*111114211111111221144488537848577999779664311*1131411111126415*4*721*1865114346
5554455654687546665645666664478774344336744211111111112121111111111111111111111111111112116437672566765743787359961214764*3211115581754211118744115756
555566664532344454*54445766554777433443*643211*1111111*111111111*1*1111*111112211111111111222587776776547*88445879211576945211115861976421129847313566
4555*4444564323333445455*5766454674354433433111111111111111111111*421*1111111522111111111*332339867388*854788676631826978*1*7113*565698958*78879512654
45654533*5666554444*54*476*465*45653454443441111111111*111111111113111113211261*1111112122324537777566*87897767653182688781571148754498867689899621654
5555*113*756657666*6654*666667345567346334331111111111111111211111111111421*1711111111211455345688864343578*5*74425946997818421843572*97766798*8531765
55312232221*12*111578566567667674765564443*41111111111111111111112111111411217111111112114332654433346553244343332996679833911*8687824*7838896975*1547
56532222443434543222426656576666656654445532*1111111111111111111121111114111161111111*112154475245445564554*552271995769925811555675*16782899588662484
455555455*76322234544475675*564567475645543511111111111112211111111111*52111*511111111111543465524*43123424414447449289671*9116664685167969744*8851135
5655555556765545324553766*66566477*566455435211211111111112111111*111114111115111111111*12334122332122433363574756684986519811*6657651*697974*89863255
*6544565*66554444345544566*566*656755575445751111111*1*11111111112*1111121111311211*1111114454554444588874876764175684481195116568*564*788587759*65416
56*455566565556554*465556*6656657355555655567111111111111*2211111111111111211211111111111145*4545665867*57876669164756591382237676656736785677*8966414
56546555*32222223333575566566556576654*555334111111111111132111111111111221111111111111111354557876734*6673266*8194688691591147765565*1767767689977*92
565565*46666555566444476457555765565676655453111111111111111*11111111111111211111211111111146544667**65*655845814189647726911654356566*87567886*7884*5
565542432434444544543557647764*755556*7*6*554111111111*1111111111*1111111221*1111211111111124465445655555*55785584447676369115544665421787666446*86388
5655443333353433434433653434674375455*565644111111111*111111111*11111111132112111141111111115555555567865584451654874272666*15556555544356534763785359
555532444411335445443445452466647655*556554511111*111*1111111111111111*111221211112111111*116666768778345546765555335371745124*4665453326*568474685348
4555*63234444324255*72336574376556765434564412111111111111111111311111611122111111111111*2111*7**54536763765418664446*8272231344554545287866658*997129
555555763*4344564444*52356473566566556554445*4111*11111111111111*11111611111*111122111111*1115456555754*6*661146621118737125244654544429*86867*9997122
565562344543445654335543346733566575*655565627111111111111111111311121511121111111111111112113766655455666681856622*17724314234442344419546*6849985432
455514543236745655753445432766555*6632344333211111111111111*1111211112111122*11111111111112112356*5454666677158*7331129*171115454457662876885813541441
56554444443**677567733454*43773*3765324334333221111111111*11**11*1*11211*123*11111*11*111121112575465655675*1476*44111944811*4**45*5571*98883841113232
55635554444322234*5*5532453325634457555544431151111111*1111111111112211111*1111112111111111111112655567525619855797512*167*1145*55564314898624*6542611
456*66643334322223444663345333774*4655665641543111*1*11111111111*21121111111111111111*111*1111*1256*55226*43718669772222661114564543*3261*534361441711
45555**14423344422233437545363237434666788162911111111111111111112121111111*1111*1111111*11111*111577455542689*729889127721116435334551585122456114211
4566361143232234432234457763262*5644455455481711111111111111*1111111111112211111112111111111111111*75566718293*529888*15611114*234454415*6423445455111
455555323334332233443334576*334344433334219772111111111*111*111111111111111111*211311111111111111114267781945*1517876*12311113334444452243452126773111
45644333222222*32232456565*75422474433457261522111111*1111111111111111111121111111211*111111111111*12565351911171299881111112544465*776*91653421111111
4563241122222222233345425556*532*75434*343321111111*11111111*111111111111221*111114111*1111121111111154*2915211712159*111*112445553223**711241111131*1
46543224322222243233*6544*556*44313445663819113111111*11111111**1*1111111*21*11111123311111121111111124519611328135*111111111873212111174511*245455212
455563433432221*443344553323766452222245*949111111111111*11111111*4211131141111311111*111121211111111165188111161122211132111522112412172*11111*111241
5543235423243212222234465421228*5332233219942792111111111*111111114221*2112211111*1111*1123224111211123714815*4386664441143122121222322824*15777777889
45*2*2*54431332112221345665*2136953*32221*92*8*3*11111112311*111114141112211111111111111*2211411122*11122262554267999423114121*23312221642346666565454
46564532133452222212355445565222275567781971128711111111111111*1114121113*11111111413*111112132111111211241*494467997652212211*322*2222971*5344576**87
*6566355211143311222277644446*2225757667193*4279111111*121111111113111**55122111*141521111111*11111112212811*75667779761112312322322222951*14678445988
455653545322*5542122346744455422215876671212655*111111111111111111211111261111111111522111111111111111*15422955767569761221222*21142121322137*97456897
4*541456*44423677755235322112232*221*1343111*82*1111111111111111111111111221111111111211111111111111111*1132934*8867751211111233222233*111278558667899
47522123464544*55567445332334333332221111421782611111111111111111121111111211111111112421111111111*1111*212*744469*8723321223433224533411116*6776667*9
45622221111122743333234455543455444333*37*326835111111111*111111342111111111111111111151611111111111111111111233478644344612*2223213222333597797776797
4631111121111232224433222222367642333*3285317466111111111111111*122*11*111111111111111317111121111111111111211*167544*2*45122223*222212332698*8*8868*8
463111111111122665444433444366777766435541*6734511111111*111111112211111*11111*11111111151111111*111111111121138751157632331331222222222125345*7999986
46311111111111244566*5665455777765*2112*15986793111111111111111*13211*11111111111111111121211111111111121*1111192*89888*4211134441132*3411*34411*11212
4523111112211*1143*3334345465331112221214855887311111111111111111321111111112211111111111122111*1111111111111111496442111111114231112232*8999311122111
46412111111211122222*22222122222*222121886*322411111**211111111*11111111111113111111111111112111**1111311211331157862111111111112222111111122233352333
*543111111121111222222*222222222222222197555667111111111*1111**111111111111112111111111111113111112*1121111123113221111122222*2111132**123222271233323
46111112111*1111*12*22232222*2222222*327*44455511111111111111*1111211111111*1111111111111111321111111111**111111132242322*2122323321222*13329822231233
*7*21111111111111122222222422*242222221977767681111111111111111111311111111111111111*11111111211111511*1141*1111143*3221112211243252113123*32152233441
3621111122121111*111122*222222332221221777*75681111111111112111111111111111111111111111111111411111311*1113111111111112121145321123211213*124185114523
46222*33*22*111111**1222223322234222111*766755*1111111111111111111111111*1111111111111111*111311*2*211111121211*111211112*213354211322112*224331347531
4631*222113111*111111123212344*2211111274556665111111111111121*11111111111111111111111111111211112111111*111531111232221111111*2541*341112232612883265
46431122111211*111111*1111111111111111*6632*112111111111111*31211112111111*11211111*111111111111*111111*1111112111112221312211222111123311212226334715
46421222211111111121111111111111111112653467*6311111111111113222111111111111121111*11111111111111111111111111*21*112221222211111122111131112123732*634
36211111111111111111111122211111113998716314631111111111111111111*111111111111*2211111111111111111111*1*111111111112112223**23211122222132242224315173
45221211111111*2*111111121111111114554175497*11111111111111*1111111111151111111111111111111111111111111111111*111112222122222*2211122421122332232142*1
45321112*2211111211111111111111111122121121111111111111*111*111111*1*112631111111111112111111111111111111111111211*3222*222122113313121622123*41231163
46*1*11111111111111121*111*11*11122*111211111111*11111111111111111*11111*311111111*111211111111111111111111111*3112422322221122222123**535322221222222
4511111111111112222*22111111111132111111111111111111111111111111121111211231*1111*1111411111111111111111*111111411121244442111121113453355331*12211221
4631111111111111111111112221111122111211111111111111121*11111111111111111111311*1111113111111111111111111111111411121623433331111113332233222221112211
353121*1111111111111112211111121111112211111111111121111*111111111111111112111111111*1111111111111111111111111121121121*212223211*11246454335*65658821
45311112211111111111111111121111112321**1*1111111121*1111111111121111111111111113*112121111111111111111111*1111111113622224222*12165864423334222222322
3*21111111*1111111111111111*11111122112*1*1111111*1*311111111111111111111111111121112**11111111111111*11111211*1112211222112121111421375344632354333*2
4611*1**111111111111*111111111111122221111111111111111111111111121111111111121211111111111111111111111111111111121211442221*12112432233333344321122334
3611111111111111*12211*111111232**11111111111*111111111111111111*1111111111112111112421111111*11111*1111111111111111432*12212111535322222255444*978773
352111111111111111*1111**111221122*1112111*111111*11111111115121111*21111111123211117512111*1111111111111112111111112222*11111224*43443666552433224222
352111321111*111112231*1111221*1111211111111111111111111111*431*11115*1*11*121111121321111111111111111111112*11*1111122221111234433*334543562133324421
352221211111112111222111111111*1223321111111111111111111*1113511111131111111111111121112111111111111111111121111111*112*1111*2111112334476468464343433
3521111111111111111112211111211211223211111111111111**11*111111171111111*111111*12211122111112111111111111111111111112311113323312333333*55*3*51214482
46*11111**11111*11*123211111111211122211111*111111111111111111117111112111111122215*1*15111111111*1111111111111111122211113456441*6443421224*243113221
362111121111111111*1111111142212212111111111111111211111*1*12122*11111111111111211711112111111112111*1111111111121126211113851111111144114111123112331
35111111111111111*111111*12111112232111111111111112111111111111111111111111111121131111111111111111111111111111111131111221112211111**1111111111111111
361*1*1112*222342*222221*33432*3122111111*1111*11121111111111211111111111111111112121111111111113211111111111111112111111232443*3331111122331135564311
351121121122*22234321*11112332332*22111111*111111121*111111111*111111111*1*1111111121121111111112*111111111111111*111111112232*2332123*323321141254411
353111222211111234**223211132212*123111111111111111111111111111111111111111111111*23112111111111121111111111111111*1111122432234522234332332*132113*11
35*1222*2232*222222122311111111111111111111111111111111111*1111111*11111111111121*111111*1111111132111111111*11131111111112444463511323224311111121111
36**32222*1333*22243233*121112211122211111111*1111111111111*11*111111111111111111111111111111111121*111*111111113111111111123123321233333*311111*11111
36222222222222222*222221211222*12322211111111111*111111111111111*1111111111111121111211111112111111111111111111211111111112111111113232223111181631121
35111*2221222221122131114112*21*222231111111111111111111*111111111111*1111111112111**111111121111111*111111111111*111111112211121*13233333*11171331111
35311222221121121222221211111121222**1111111111111111111111*11113111111111*11112111142111113111111111211111*11111111111111166**5111211111*1221*1215412
3633211*2211222222*22113121132222213311*111*11111**111*11*111111311*111*11111111111132111124111111111211111111111111111*1112111211111*11*1211112167621
231*33111111112211221*23*111212122111111111111111111111111111111*1111111111111111111112111**11111111111111111111111111111112223221111111222111143646*1
33*1112233*122121111113*11122222222*221111*1111111*1111111111111*311111*1111111111111111113111111112*1**111111**11111111111*34411111111111**1111124621
35111122*222111111122122211222222222211*11111111111111111111111*1611111111111111111111111221111111*211111131111111111111111134111134242113211*11132621
222*11111112221*12111111111111211212*1111111111111113111111112112211112*1111111111*111112**11111111111111221111111111*11111111111111212141122211226721
2211111112111121221111111111111111111111111112111111111111111311*11111211*1111111111*111161*11*111112111121111111111*11111*111121112221112311111113611
*22*211111132121111112112222133223*2111111111*111111111111111111111111111111*111111111*111111111111*11*111*111111111*1111111112511131111112211111111*1
2*22111111222234212211112*12*1222223221111111111*11111111111221111111111111*111111111111111111111112111111111*11111*12111111111*1*21221111211111111111
22121111*1112112221111114332112222221221111111111111*111121**3111111111111111111118111111111122*11141211111*11111*11121111*111111121221111121111111222
3311111122221222212222113223433333333431111111111111111111111111111111112111*11111221111211212121122*1111211111121111111111111111121211211211111111211
3211*1112322112222*223*1323433333332134111111111111111111*111111111111121111221111131111211311221121*11114*1*111311111*1111111*11122221221122111112111
212222222221221211121*112111243333322241111111221111111111111111111111121111111111111114113211111111111111*1111141111121111*111111233112*221*12*111112
332122222211212111112111111112123444114211111213111111111111111111111*16211111111111111411111111111111113**111115**1111111111111*1134122*1124261111121
43211*1111122*321*22211122111111123**232111311111111111111111111*11111151111111111111111211111111*11111151111*115121111111111*111111341111111111223112
222111111*222232212221111111211111*4521111*21*1111111111111111111111*1141111111111111111421111111111*2*131111111*111111111111111*1111311111*1122322211
452212111111111111111111223332231112111*1111111221611111111111111*111111111111111111111*211*2111111111111111111121111111111111111111111111111211112*11
343111111111*12211211*112*321112211111221111111111411421111111111**1111111*111111111*111111*211111111*1221131211*1111111111111111111111*11111*12111111
331111111111112222221111221111112111234111111111111112*111111111*1*1111111111111*1*11111113*211111111*161*1311111*111111111111111111111*13*2112*112111
421111111221*1112**11111113331*3211332111111*1111*111144111*1111111111111*1111111*11*2111134112111111113*11321111**11*1111111111111111111111121111*111
421111111111*311122**11112*3313331122111111111111111112211111*111*111111111111111111*1111*13112111111*1111112111*1221111111111111111111121112112111111
311111111111111113*111113212112111121221**11112111111211132111111111111111211111111111111112111111211*1111*15221211*2111112111112111111111112142124211
311111111111111112111112212111211111331121111151111*11111111*111111111111121111111111111111111111*21111111713*2123112211*111111122111111*1*11122113221
32121121111111111*1111232222334211141111*11111121121111*211111111111111112111111111111111111111111111111111*111112111111112*111112111111112226611*1232
32221111121111111211*1321122331111121211*111111111121112**1111111111*11111111*1111111111*11111111111111111112111111111111111111111111*1111111483211433
311111111211112*111*1131*11231111121111*12*11*111112*111421111111111211111*111111*1*1111111111111111111111111*1111121111111111111111111111111163452*46
*311111111211121*1112121231*11332211121231225112111111*11331111111111111111111111111111111111111111111111111111112111*111111111111*1111111112111111111
3211111111311131111212212312333131111122211113111*1111111121111*1111**1121111111*111111111111111111111*1111*111211111111111111111111111111111111211223
3111111111113321111211112213322432112231*12242211111111111111111221111112111111111*11111111111111111111*1111111311111111*111111121111111*1111358743322
31111111111123111112211131133*2333113*2111211*111*11111111111111121111111111111111*111111111111111111111111111161*122111111111114111**11*111*522323442
321111111*111111111212112113313332113311211*121*11211111111111111411111111111111111111121111111111*111111111111131111211111111123111111111111423211213
*211111111111111111*321111**212333112*11111121112123111111211111121111111111111111112111111111111111111111111111111112111111162141111*1*1*111212432334
32211111111111111111321122113123321121*11111121132131111113111111111111111*111111111221111*11111111111111111111111111111111**71131111111111111133**122
31111*1111111111*11133211111121132312111111242112211111111111111111*11111111*1111111111*11111111111111111111111111111111*11111*112211111*1111154767633
3231111111111121121122111*1*23113321*211111222111*1111111111111111111111111111111111111111111111111111111111111111111*11111111111111111111111152444434
2344211111211111111111221122121111121111111**2311211*11111111111111111*1111111111112*111*111111111111111111111111111111*11111111111111111111115444323*
3222*2111111112111111121112211*11121111*1111112223211*111111111111111111111*1111111*11111111111*1111*11111111111*111111*11*1*111*1111111*1111144778989
3111111111111133321132122111*11111111111111111122*2111111111*111111111112111111111*1111321111111*11111111111111111*11111531111111112112111111221121111
32111111111111322211332*321111111112111211111*112231111*11**111111*11*2132111*211111111*111111111*1111111111*111111111*132111111**11111111**1111122211
321*11*111111142321123212311111*111*1111111111112*311111111111111111112122111141*111111*211111111111111**111*11112*1111*111*111111121*111111232*111222
32111111111*11*32*11123113*11111*11111*1111111111222111111**111111*1*114442*12111121*1*111111111111111111111*11121111111111111111111111411111214121111
32111111111111*23*1112211121111*1*111111111112211222111111111*11111111333431111211211111111111111111111111111111131111*111111111111111*311*25132**2243
4*1111111111*113211112211*12111*11111111*11111*1*111121111121111111111121111111*1111111111111111111111111111111212111111111111111121111111111125222222
32*11111111111121111132*111111111111111111112121111223111111111111111114112111111111*1111111111*111*1111212112221212111111111111232111*1*2*23311111112
3211*112*133111133456323347313462723332321224554333221241111111111111112112*1111*11111*112111*5111111111132125131111311*111111*11241112121621*22322122
3232134554*5112566766677776253771724333453447776*3321157311111111111111133341111211111211111*17111111111112115*11111211111111111211111*1128431*1111111
