1111*1111*111111111111**1*1111111111111111111*2223434**544*44655533423441223*12333*323*43323**222**42*2231*221*22*222223141**21322*221221*221111111111
1111111111*111**11*111**1111111**11111*11*111122234*34454644375564332333*2*2221454*234333*2*22222*222*222233*454*4**2*3324232*2322*2111121*2222*222222
1111111111*111*11*11*11111111*111111*11111*111*22333*433446655**645442632323**2444*3323333*32222222222*12232222211222223***22344*444***333*23322*22222
111111111*111*11*111*111*1**111111111111111112322*254*5444*64*5*45362242*224122**4*33323**22*35*3222*222121222252*222*2*21122*112*21*1211111*1211*1111
1111111111111*1*11111111111111111111111**11*122322244*5*4446564*45553224*321222*333333323322222223222*1333233*241*222*3322241211111111111*111*51**111*
1*111111111111111*111111**1111111*111111111*223*23245*4444446**3**45422*224211***55323**332321221*2321*323443**3111112332215*21211*1*111*1**1*51111144
1***1111*11111*1*11*11*11111111*11111*111*112253232*2433444563344444322223*2*2*2334**33333212442*2252222222*2*24111122*2**222*222*22222*2222*35*1*1143
111*111*111111111*111111111*111*1111111111*1133322322333456553*3*64352**2***221*33333333232323622222*22255347*55*55*444454553233333333333*433*211*2232
11*1*111*1111111*11*111**11*11111*111*11111122*2323224335436445355432*3***22222244444433333232*22*32322343332212111111*111112*111111**1111111**1*1*111
111*1111111111111111*1111111111111111111111123332*222333554**5*4444322*21*2222234433333*3*22*2223252222343332322222323**233*44445433333332222222*111*1
111111*11111*11111*1*1*111*111*11111111111112325332222*35456**45*643*3*24121123*4353563*32222222*22233**4443334433333333*2222**1111*112*23*234*3333*44
11*1*1111*111**1111111111111111*111**11*1*1122243222*3545456***4*344222*222*1122**423**33213322*2*223*457*44*222*1222212*2*14222*111*1311111111111*111
111*1**1111*1*1**1*11*111111*111*11*11111112132333*12354*654436634*5221*11223422*433333233**32223222245887765332**1**2212232521*111111212111*11111*11*
11**111*1111111111111*11**111111*1111111112**323*4*222*5*45*3354543*233221*232222*3333*3322222222222345785*433233444*4431*11211111221122211111111111*2
11111111*111111111111*1111*111**1111111*11222*2**2122*36543**555443332221*223322*3333333563222111122335575555*22*22**21*32*5*3444*333**22111*111111111
1*11*111111111111111*11111*111111111111111212322232234*36*34444655352***12*25222*33444323222222223232244*44**3232*222122122732*2**1111111*1*12223334*5
111111*11111111111111111111*11*1111*11111*121***2223234634533365*55*23242122*322**323**34*2222*122*3*4345443*322223*2*1*1*2*41*1*111*1*111111111111*11
11*11111111111111111111111*111*1*1111*1111*22*3322*223443336336*45522221*222331233233434232222*2222222233*44*522324*4443*222*22211**11111***11*1111*1*
11111111111111111111*11111*1111111111*11*12223322222335354334*655**224111222*2*24*4*4*34*3222*2222**222322*23322222**22111233*233222222111111*11112452
**1111111111111*11111*1111*1111111**11111111*2222**4**34*3346444322*4211**22*2333335*323222**221**33221222222*2*2154*4432222***111112233*54*3***112543
111*11*1**1111111*1111111*11**1111111*1*11*22222*33*334322*465522*13212222322332342343*33222222112222254*2**22221252222112*124432221*11111112222**2443
1*111*1*11111111***1111111111111111*11112212122*2**3*3253**55322212112*1222233*333*43332233322***2*212**23454332**3222221121111112*333*22222*2*1111111
1111**111*1111111*1111111111111111111111112222**2443423235645233*2412222**2333*433333222**33121252*32111212222*22*42433322*111111111*12*2333*222332112
*11111111*111*1*1111*1111*11**11**111111222*1332343352*6*344222**41121142*32334533*45423*1*2122242223444*222*11*21221122112*343333*221*1*1112211111222
1111**1111**11**1111111*11111*11*1*1111122232**2*35223*5544232121213*122222235544333333*2*222332322*22222245332211234*2**222211111**3444322111111*2211
1111111*111*1111111*111*11111111111111*22111**32342223*34*333213*212*243*2*334443*333*32212112*422322354*222*22233333335*32324432*21*1112233*3*22***1*
11111111**11*11**1*1111111111111111111*22*2122333424343433*622211121112232523*45322334321211**13323322121333522221222335254*22244**4311*1112*11223343*
**11111111111111*11*11111111*11*11111122112222***3223*4*3**221*111*2122223*2*333323333*222242*3441112*11122141111*2211111***2*3244324**123122112111112
11111111*111**1*1111*111111*11111*111*2*12224233*3333533222112411222212*22*2222**32**3222*442*2*12121*224231**111**2111**11*22*1431241*12212*142211111
111*1111111111111*111111111**11111111122222*3423433*54332221122*112121222322*4412243232222*4213*1121*5221122442221*1113312111*11*1112**121113**4**1111
*11*11*111111*1*1*11111*1111111*11***21**2*43243*42*333221112222*1222**233333*3323*23412***3223361112122233111111233*11111122211111111111111112*311111
1111111*111*11111111*11*11111*1*1111112222532435*3*343*2221**1112211222*3*32*23*2*3*2322*33*2*331311611121344*3211222353*1242*34*2221112111*11*1111*1*
11111*1111111*111111111*11*11*1**1*22222243*3335*2*3332*11411**22211222333*3222223**223242322***512141111221112335*3*2**432111112*45332211**1111111123
*11111111111*111*111*11111**11*1112212***2332*33233433*21222321*1223*233533332232423*43221231*4211122***1122111211***3322211111*1112223*2331*31*11*222
1*111111*11111*1111111111*111111112122*3223*3342233432422122*1221221*2335232*21*42324353242312222**21*2223732222211*111211111111111111111*3*442111*1*1
1111111111111*1*11111111111*111112*222323223443*23*3*211122*****21*2*23*3*222212542332531121152111*311253*2122***21121111111*4321111111*11112*111*1111
1111111*111*11*11111*1111*1111111123232*2434332223422212212111***11133322*322224*324*33321113*32*11***1114**23*232111112*111121*4431111111111111111111
1*1111*1111111*1*111111111111112122222242233422343**222*12122*211122*3333223*123**4*22222122*21111*31221*312224222421*211***1***1*12442211112111111111
11**11*111*1111*1*1111111111111*2*33222333*222*233*2221211**111*122332332*31123**43**3613**132231231111*311112*222252*3121**11*111111111***3211122**22
111*111111111111111*111111*111222242223344*2*242*34*111212112*12122**3**24231242*2*3322*1212*222*342331221127*2311223421111*322111111*11*1112443*12223
11111111*1111111111111111**21*2232222*4332222234243*21*1222*222*2233332222222331*3333**12122*2333212122*4112242121*23111**2*22*42**111111111**222*3223
111111*111*1**11111*1*1**111222222223*4224222*2234**13**11*321222***322241*2332*3*2222322111322232121*211233243322*111*2*25*111123*3*11111111112211264
111111111*11111**11*11**1112*2423222333232*23*344*32121211221222223223*22322222*333*22*21**23323222*142112222142**4321231411*421111223421111*11*1*1366
1111111***1111*111111*1111122*223323232*2112223442222*11**1*42*2234*2222123231*243332123122232*32411122111*21323*11*3321221211**42211*122*134211*11234
111111**11111*111111111122233232222252211*13234*3112112**21222222223**2*2123**224225*32211*223**12111*31111116212423112*111*1*111234211111*1*323*11222
11111111*11111111*1*11*31222222443523**122222243121*22*221222232*322*325353222323*2112**11123*2241*23221122***1121222211111111111111114652121*2342245*
111*1111111111111111122222232*34**1*11122235**22*112*12222111222*3222**2*323232423612**133*2322121112*34*311112*213211*11*1111211*11111*1**31111222455
1*1*11**1111111**2113211*22233*422211*323542*22*121***22122122*3322*224*22*22323*4*11*12231*4*231*1112112211121*2123*12**1*1121*1111111*124211222*2355
11111111111111*1121211222253242242*12223*22232122*2111222212*32222322234*2324322**23222*112322*3123223*21111*122*222211111111**532121111211*12**112*23
11*11*111*11111*111*22122222222*22112*2223*121111111*224212*22222211233**323222*4*2222321122222**1**131221111*24222***26*1111111134311*11*1111221142*2
1111111111112*212121123323*2*2311221*322***2*2*1121*231*3*13232211*3*3221*332322423221114*22*131*12*3111313*11*2112*2231*32212111*2*4311111111111*111*
**1111*111111*11111*333233*2*111*2*2521*21121*1*212222*21*2*32*222*1323*423***2532122111214212*2132**11231*11*1*112*244*212*22111112112421*1**1221*11*
111111111*1*1112222**2332*2111*4**1*22*11212232**3222*221*223***22***32323*4242*2221212211*32*111*1*211*133121111111*14232*23522*11111**13*2111122111*
212*1*111*122*2233222**31211112**1*21*21*22221222223212122*322*233*52233243*2*2424132*2221223*3*11*21123*433*2111*322*1114223312*33222*11111234**11*11
2**22*1322***23*2222*22121112*1*1111221222222322*21*1121223243221*4*3**2323333321123**2221413122*12112131233**421112*3*11121**2333253111*11*1112*32221
*22*32222234322122322112*222211**122**2322*232**112122222222322**42***23*24*3**3***1333*222*22*22*21111122123424112222121*1111234214*5*21211*11*122343
232323**233*122*222211221*11*122111121*22*3**122111311222*2*232242*323**22233221312222*12222313*2134211*111*23332212213*121211123732526*124112*111*111
11*12*21*111221**213*21*2121121**3222533222**211211222*222323*1322*33323322*231113212231113221*141*143*11**1112*3224***122311**111242*32424211111*111*
2111211*2*112121*111111111*112*22222323**211*111111**23*2313114223237234213222*11*24232211232242122121*311111112234223211221211*1111123222221122*2111*
*1211*1111*1*21*111**11*211*2222*322222122*1**1***21*2*22231242*2223*331242232*232134212243*224222133*1*4111*11*2242423*3212*31112111222442322*1331111
1221*1111*3121123222122*1222123334**12*12111121121132312222*2*3231432*3*22*211231111*112**211211*13222311153*2**1*44225223*41*2**1*1232**1*222232**142
1*11221122*234121222*3*3223323*21121211222112221**2313322222*2*23*23323253*3122322*4421*3211141*1124311*2114*1*1*1*222232312231221*23**41*1*2*13211*3*
*2221*2221*22222*222222232*3222221*21*111*121111*22*3222223***2*2*222*22632122512224211122**4112111123**221124211224*1132424*4222222411342**22*2*11*22
***2222223**322*33233233322222*2221221*111111*1222*2422222*33*33*2222*23*21122112233212432*2111211112125222111442112*112123422**1211*2312*11111*1*13**
212222*2222122*2322222*2*2*122221221***1511121*1322*22212724*22122224*4*22*12*122*1*12513*1***11*1111112624212114221*1*1112331322311*241*1114211111211
222222*222*23322222*2121223*21211121**121*1*2*2223221222725222262222233321251*2*1*31**22213*11112411111*112612121251111*111122413234111331*23213111111
12***22*22*22**2**222221211*211121**11****2*22**2222*23423212221*3322622*11122121211221321*1**1211211111*1***3112215**4*2*11**2322552**2*221111212*121
*1*3232222*2*23112112**211***1221*1212211*322232*2*1215243*22231232*422*222*21212*1*222*1*1*11121**221111111215111122211112511112211222211221122115**2
1211211212122*11*112111211111211121231121122**2*221233**22233*22**33232121111*12*31222112112122**1111311*111112*4213211*321113**113*21311252224212*113
*12121222*2*111*1*111212121*22222*12412*22232*2123255*2222**2333234213*22112*11322*22*2*321121*111125111*11111*121421*312331111232*242221235*1121*1112
211111221*12111112*21**1111111111*1*222*321*233*2***23232244333*32*311211112222*132222223231111111112113*11111111312*3211*232111242212411424332*232111
1*111*1*121111111*11221111*11212332112**223543322232*22344*33*222227*112*1*2312*224412421343211*111111*5111**12251113112111*2*2*1124211**1253235*21221
21111111122231**112*1111*22112*334323243*3**223222*22**333242322222311111*2233222321122*22342*11111*111111111233112*112*4211113*1*1*232115243234133*12
211221*211121**1121111*12*22*3*34***23*22*2**22232*2333*22*232*22331211*21*122*23211*11*22**31111111111**1*111*112****4*23*21111321112241*143213223222
53111**22*121211*11211112322*23334233333*2*333332333323*22222*221*2211*122122114211*213111123432111111111111*51113112*211*2*2211133*111*4221232*252*54
*1*2221211*11111212*221*2343333344432**4*423332*322233333*323262211*12111122211*121112111111123422111111111123124224212*211112*1*112332*11243*24132*33
222111*112111*152*41*113*2*34**43323**232233**3*3**33235233222231112**1*21221*1232232*213*11*2243111111112111123**2422222**111122211124111122432*21142
232233233212*22*2222*2223*225433232332444*2323353333*242232231211*2122112211121*1224*213121*111*11*1111112*1122*11*222511133*1112641*114411*1**32*13*2
33322242222323322*22*4423333*2*232**2422252323*333442***2*46341*431222121123*1*1112*1131*111111*2*11111122411112*11113521122421113211111*53211113*22*3
434**6335336*4433334233**33*522*22*33*23532333334322*3**1433*311111*21212*41321*122113111111111*11**111111252*11421143132211**3111124421*1242211123*21
**3434*344*344335*42*23*33322223**232233**223*2*33*3224233*2321111422212163*241*2221221111111112111*11111211*311122*11114421112321***521*11*2421111232
33334363*33*36554634*3332434*363333*432*43*2323*233323252*24212**11*11112224*22121**21111*111111111*111122232*51*22211**124*11213113*5***11112*3*1*11*
534323*2443332333334422543*4*42*2333343*223223324*22224**342122122212**23**21*221113*11111111**111111111111*111332*12*31**135121*23122111111111*3**111
221353242222234*54*3*33323422243***222*2233*32222232*3223*11122322212231242124212231111*11112*121*111111111325*124261112211123421**1111111111111122321
2243*232*2234*6*3**2*33322*4*423*222312*3232*323221622*532123211*2334*122113121*1331112111*1111**111111111122232*12231113*2*111321111111*11221111112**
332424254334343253333223232324232332223****2*23234*31*2*112*12*1142221*2221121*4312111221143111111***1111111222*52133511*242111*431111111*222111111122
223225324335252*343322**3232*22*33232243*22*21111332122112*2112321252**72*212121*22211221*143*111111*111111*11*534*21234*12*2*1*133211111111111**1*11*
2**4*2233*3223233223*2323*3232322233322*22211311*12*11221*11*211422221213121121125121*1****1*211111*1*11111111125*5*11123**12**11124*1*11111111*11**11
342232***2*23232323*2*232222232*224*242***2*321111*121*132222221421222*11*211121126222***1112421**111*12*121111*122341112*11*2*2*1*1*32*1*1111221*1111
422232322**32*23*2**24*24653**2**2223211122211*21112**22122**22124112*241221113321241211116*113*11111112*111**111*2332*11*511114**1*124211111221111111
25342222*23*232312122222*2*225222322112221*121211*14*2112*22222221*2*1412211322****1*211122*211*32111*1111*1111111114313211251*12421*11244211112*11111
2252242222*24*2212221221*1**4*421*12*232*2314*2411221112235*2252232**1151214122222*1**21**11*11*121*111*111*1111111*32223211142211421*1*12**111**42111
*112421214332*41232222**1232342111*1211*211*1211*212*21*233422132***221151315**2**2*113*111121*121511*1*11**311122111*211431212*111**111111*421**12311
222*32422*2*323111***1*22122111*1*22*25221**1112111112*11322322222114*111321151146221***111121111153111*111111111111*1211**41111*11*2421*111*3311*113*
**23131232*22*2222212*2*223*21112*11*222211113*21*111311112*142112*11421*323124*22221111511*111111*2*1*1111*21111111111111123121*5*1*13*43**1*33111111
*2*112121522*22*22*1*4*3*24212*12132*21311113111212*2*621124*212114111111132212212411*112512**11111252151111211111111111111**321*143*113212311124*111*
122**32*2*2232224**2122424*2*112222*22*11*2*1*212122**1212121111121421*2**2231131122211111*1112*1**11*3211113111111111*1111*1133111341***422321224311*
*1322142**1*11121*2*333322*22111152*211**3*1311112211114111111111221*142*21313215215121*1142**31121*11221111211111*1111111*11112221*14211262133112232*
2332121***1**2232122111221321413211211**122232*33331*1*1*11111*1*321311141112*221411**1111123*11111111*15*11111111111111111111*113*11222121211*4*11**2
*2211*112221232231**211143*13111*11213*1222123433522112113111221*2**241*12111413214114211*1*22*121*1312*1211*11*111*111*11111*111133211332122211431***
11122222232*11*1*1*11111232211*223*211332214*334*112*1111311111*222*11*11*111241*113115211*1112***112221*32211111111111*1*1111111*1241111123*42112*212
2*23222*21*112111111*11*22*21*2211*213221412*321*1***111114311**2*12**2*211111*31322211411111*4*121*1322**322*1111**1111*11*1211111224311223*621112421
11121222*2333*21111123*11111*1412211323121424112234252*111*2111*522*3214211112122321*1*23*11*1*2112*42232114*211111*1*111**1111111111*3*1**3*3**1113*1
233*35*2111*22321111211111*111311*231225*22131213*1111*1*1111*11**31421*2121131141111411231*1**2*144*22421*1*22121*11111*1111*1*1111111441113213211112
22134*2111*2*1131*1111111112141*12222*33211*1122221**51111111111*41*2*3122*1*11114**1131**111111*434*5*11211*322*111*221112212*1111*11112*21*112431111
44331322*1211*22*211*1122221*3*312121111*133*2*31511*1211*111111*14212311231111*1141211*11311111*14*42121*3*111521111112*1112*1**1121*11112422**123*11
22131111212212222*12*21211311*22212**2143*22*1212**1**5111111111111411422**2111111*1*1*13115121111142*3311*2211161*1111*1*122*1111*221111*1253211*1332
221222*14223*52*112*23**1141211142*231*32111111*3231*122*11111*1*113*11521*2111*1114*121321241*11122222*211332211*12**111*11*11111*1111111*1*5*211**2*
3121222**1*4*412113223141231112*41*212122211211321*1111211111*111111***25116**1*1*1**211142113111*1*22*121113211*2*2212111112111211111211*111**2211*12
*1211221311313*311*22212111211312112122*4*111624*535*1*13111**12*1114111231***11111*23111121122*1**12322111114*111*632*1*22132*11112112111111112232111
*121222132231324*23445*121131131121111623211122**122*11111**1111111123211421121111111331*121113224*3122321111142112*32211*11*1111***11111*1111*1*45211
21213*313**41224*131*2412**4112214***2321*1*11**21*2311111111*11111123*12241123111*111**11**1224*14411*23211111*2**222111*11111*111111111111**11*4*221
2221413*32*61123*22132212114*1131311132414*1*16*3213*1111111*1*11*111141*1422111111***11111131*14111211224*11111511212221*12*1111111*11112**111112323*
21*141*13*231131111211212*12*1131231*1122122153*12*3*11111111111*111112*11162*1211*1111*11*12*2***124*212252111115212124222222223211*11*121111111*1122
314*423**1*2215121224221*111411*1*3111114**2241212*12411111222511111111321122111111111***11**22*1221*44111252111125*1221432*2222211111*11111111111*1**
3*315**12*112231*1*2132*11214111212**211312221*1*232422111*2**12*1111111311*42111*111111111**232*14*1*35**22****112**2*2432222222111111111*11111*111*1
*12142212211*1313*2*13211**1412441222122121*413132212251114311141111111**2*21611111111111*1256*32*2*12112112241*1*1*422*233*22222*1111111111112111111*
2131312135444131411*121112*131*1*11*23211*2*214*2*4211*133*121*2221111*113111241*1*1*111*112*6422222221252111321*222242**233222*2*2*11**11*1122111*111
21314232111141214112*2121*1121116*12**11142211221421*123*14141**31111111*14112*2211*11111112563*351132121**112531532244223*3*3222*2211111111*111**1111
113*3111*211412131121124*1*1121****1*1*11*12*3**1211111*224113111311111*112112151*1132121112222121111**1112211234*222*44*33*333*22221111111111******11
114131*11311****31221133*55113111111112*1*4*322111111111*1111*212221*1111114112151***6213*2211*33111*1322112311332233*244*444434221222111*111221111*11
114131111311312221331*31*12*121****11131113221*161*1111*2*12*131114111*11*12111124111*22321215*21121112*4*1*23113***334444*5444332*22211111112211111*1
2141*11**41*31*1221521312253*1*1111**1*11113112131111*111162**3211121**11111312*1221*141**11*21114*1*11*22****22*3**3444*55554435*22221*11111221111111
1*41311114113*2212121132*22**111111111221*142**21311*11*11*2111311*31**21*11**1*214111144261*1*43721112132222221123*5*44*6776*543*2*22111*1111111***1*
21*1*1*114113122*311*13141*4111111111114111213242**11111111111*3111222252111*121111211122124*11312*111113121112222254454*67775543*33222221111**11*1111
*141311114112114*411*121**33**211**1111311113222*13*11111112111**111212*11111*221114111144222111711211111311111*2*23**64567765*3*34**211*111111**1111*
124232111**12*1*1*111*1122*2*1311111**1*311141413141111*111*21*1421*3111111111*1*1*1311113*2*2111115311112*12214512234355*665**3**22*2211*1111*1**11**
**112111141112141*1***12*314313**1111*12411**1**413111*111111111*2*1221111*11***11114*11*2*12211*121111*1***1*223322335444**54443422232*11111121111111
1224411111*1*2131*11111314135122*11*211161*111223114111111112211123112211*11*1*4211113211135142*11*123211*1231121*3*2234*444*4432*3*22*2**223121*211*1
12111111*11113*31*2111141**221131111213**1*12213*41*1*1111**2521124*11**13111112*111*1311*224*2111*242111112221*23332333**34433*22233224*2122111111*11
22111*1111*113131121111*1313*413111*122*1*11132314113*1111*1*2*11122122211111*11321*111211*33113*11111112121142114322322444433*33*2233124*21*111111*1*
221111111111131*2131*1**1212*712**11142124*114*12*31411111*111241*161*141111*43*13211*1311123323311111*36211124*1222*322333324*22*222*31232211*11*1111
431*11111111141221*11213*112121211*1122*1111*13131512111*111*11*1112*11221121231113111*142112213*11111224*1*1224222222222223432222*22131*142112111111*
111111111111*41141411212213*1111411111*211*1*1*1224112*11*1*11*211*2311141**12221121111122112225*111*12*1*11112331*2223322333222222222142224211*11*11*
121*111111111**1*2*11*1231414*21411*112324311121212212111**11111111142*113*421*31112111114111*13142**11111222312222221*32233*222222232213221*2111111*1
11122*1*111224*15131111141*24*31*1*111111122211413122221214**12*411224*123*1111221*31111*1211211*1*211111242211113*2**22233322232222*2222322*2411111*1
111221*1113333*2*1211211412222*11111*12311*3211316232141113*11111*11*4*11*41111*21*2*1111131115*1152*21123224421*2322222*4*11*2222*2222221321122*11111
***121**11311131*12214114212222**3111113*211211132*2*131112211111*11225111*1112112213*1*1113*21112*222121322*22311232*1*43*11222223443232*13211*2*1*11
11*1311*113111412222*63*421312***31*1*141215*2211122*1*211*411114411*2*11112*353134*2*11111121*1**423*2**24*2111111331123222221123465*2221***211321111
1*113111*3211*4112231111321413131*1111122121111*162112*4111*11111**1111111141*5*122112*11111311*23*532212*2*15*11211*221123432122*66664212*113*2133111
1*1*3111*21111*1121411112214131312211*114111111115211*131*12*11111*111111*13*2**2**41142*1*1131111**23311*1151121211132212321*222476**311721112111221*
*111*111151211411**4*11123131313113311*133111111111*1311211121*111111111111141246224211311*1121112*23*4221121*333*11123212111*222356642211*1111*211321
111121112*2*1141**2*111114121*122122111132*112*1111*1121*11*311*11111111111112*353222112*11122211*223212**212*246111*12*11*2444*22343221*1111*1332**3*
11*12*11122*11*1*313224114*1***1411111*11411111*1112213*2*112211114311**11*1121*54*11**13212*4331122123*511132*513113112*12223*4*212221121111111232112
1*1121111124**3*13122*21132121*15111*111*3211*221115612*131112**1*3*1*11*121*24233*1111113124453*112*32*3*1*2221*2*1*21132122**23232222212211*1*12232*
111121251*34112113122111**21312*41*1*111*3*111111*2461141311*41*11*11111124*1132112*111*2*1123*2211112121111211*2**32*1*122122124*2***2*3442211111*33*
1**2212211241121**1*311112214141*1111**1132111*11212*11*1*11131*1111*1111*1*12131222*1111*31112*32211222231**4113552*11*11321123*42121124344211*1*1132
111221131123*1211*21*21*12*13*4121111111*2211112*1*1***121*1113111112111*111111*3124*11**132***443111*21211*21**23****111123*1123212121*333*2111111123
1111*11111331*111*2141111*41*12112111*1111221111112*5411*22*11221112*21*111221113112*1111***1*3**41111111352121*1*23*412*1**211*2124221124*211*1*111*1
11112113113211*1113141111141*21*1321221111321111*11212*23*2311131112*4111*11****22112211111***2443*111*222*32111*2*53321*1*24*2*1*2321111*222111111111
