4445*777777777777766665666555577777*64*8*9999*899999*985*56666*6655556*5555
444*77777777777777*66656665546*7777*646*9*9998*88*889*8*5556665655555***55*
44*5777777777767775*565565555*666666637889999*8888888877555556665*555555565
444577777777776777566555*55457666665546799989*888888887*45555666555555*5555
44*57777*7777776775655556544466*6665*4678988898*88888867645*556655555*55555
44*477777*777776775*6**5*54*7**66666456778*8*98888877*6*6555*555555*5555*56
5444577777776776775555555446*6*66666456667888888877776*6745555555555*555555
554447777777*6*67*55555*445466*666654576**787777**67666675555555*55555**555
555447777777777767555555444***666*554575667666666666666*7655565555565555555
55545777777*76776*555555*55766*66655456557766666666666667655555666*65445555
555447*777777777675**5*444566656655455**556666666666**666655555555*5*455555
*555*47777*77777675555545556656665544*66566*6**6666*66666645555665555555555
*5555477*777777**7555554544665566554*5664**56666*666666*6645**556555455555*
5545*477777777677755554*544665566655456665556666666666666644555665555555555
55444477777777*777555*455*5*65555*5445666455666666666666664556*55554555*555
*54554*7777777677*5554455556655555*445666*566666666666*6664*5*5*5544**54555
5555554777777777755544554*55*55555454566666556*6666666666*45545555444*55555
54555547888****7755544*5455*5555553544**666666666666666666*5554444444445555
*45*55*78888777765*44555454**5555545*5*6566666*66*66*66666455444444*444*555
4455555888887777554545*4554555555545455556666666666666666655544444444*45553
45555555888887*5554*45555*45555553454555565566666666666666*44444*44444*5534
555555558888**655*4455*55*4*55*554454555*5565666666*6666665444*4444344443*4
45555554*8888645*4545*54554555555565*5545*556*666666666666*444444333434*44*
44*5555557654*4*454555545544555535*5455555555655555566666665544433333344443
555*4454445*544445455*545545454*4455445545*55*555566655566644*33333334444*3
4433444444444444444455*4**54544354554455555555555566655566544446555444*4443
444*44444554444*4445*5344*44*44455544455544*555556666555665454445*54554*443
6*65444445544*44444554*44444*4*555*44*45*55*55*55566**555654444455545444433
555544544445544444444344*444444545*444454455455555655*55566444*554545443333
5555*5**44*454444*44444*4444435555544*44555554*5**5555555564444455444443333
55**5555*4445444**4444*4444444655*5*4*4355555*4555555555566444444444*433333
455555555*54*4444434444444*435545*544444355555*54555555556544*4554444433333
45555555554444444444444444434554555*4444444*5555544444555*544434444*44343*2
444555555554444334444444**356555455444444*555555555*554*55*4445*4443*34332*
4444**5554*5*55444444444435665455554444444445545*5*5555445444454*3333333322
4445555444444454455*54**5555554545444444444443*544444445*444*444*4*33333322
*4445554444444555**555*55*655*5*44444444444444433*3344*444444*54*5*43333334
4*444444444455555555555*55*55455544*44*444444444*4444*4444*444*455444444444
*4*44444444455555555*555*55554*454433*3*444444444444444444444*4444444444444
4*44*44444*455555*54455545*54*54446666433444444*4*44444444*4445344444444444
54444444444*455*55*445545455554*66555555533444*4434*44444444444533**4444444
*434*444444445555555554455554546*54*5555*5334*4*444444444444445443444444444
*54444444444455***544544555444556*87*455555343*4*444*44444*4444*4*444344444
5444444*44444444444444445*44*4677777864*4*55334444*44*4*444444444434344*444
454434444444*4**44444444554446777777785445553344*44444**4344*444*4433444333
4544434*44444444444*4445444446*777*778744*555334*4*344*4*444444444533343333
5555*33*4444**444444*4444444677777*7777744555*3343334444444444*444443333333
5*555433*44**4444444444*443676677*7777*754545533344**33444*44*4*44444*3*333
555556*334443444444444444457**6677777*77644555*344444**3444444444*4*433*333
*55555565333444*444444444566666667777*77654*5*5*44444*4*33344444*444*433333
55*55*5*5*53334444*34444466*666677777*7876445553**444**4333*4**4444*444433*
555*55555555543334444444666666666777777776*55553*4444454543344**44444444422
555555555555555544454445666666666777777776*455543334445554*3334343444444*44
5555555555555554445444*5*66666*66777777*776655553444**555444*3*33**4**44*4*
55*555555555555555444456666666**6777777776**45*5433444555444543333444444443
5555555***5555*55444*566666665667*77777777*665455334445554444444*3344344443
555555555555555444*446*666*66666667777777766655*53***44554444*4443333344443
55544554455555544444566666666666*666777*777*66555434444*44*4444444333334433
5*54*44444*4*4444*4*566665555666666**677*7*766*45534554444*4444444433*33333
554444444444444444566666*55555666666*7777*766***5544*664444444444444333333*
54444444444444444555*6666655556666666677777*7665*55455554444*44444443333333
44444*4444444*3*4556666655565566666666677*77*66655554*5556333*444444*323*33
444444444*444344556666655*65**66666666*777777666655545**5543333344344432333
444444*444444445*6*66665556555*66666***7777777666645445555543*333334444*233
4*4444444344*45**6666665555*55666666666777777666666*54455555633333*44444432
4444444444444666565*66655555556666665*667777*776666745445***563333344*33444
444444344*44665566*666655*55*5666666666777777*766*66645445555553333444*3333
4433434*4456665655*6666555555*65666666677777777666666*45445555452333*3333*3
4443444445666656*6*66*55555*55*66*655777*777776766*6777454*555*552333333333
4344444366665565555666555555555666557777777*77**666*77774*445*444*333333333
44***447665**6556556655555555*566657*77*77*7777776667777654444544444**23332
444*4376666656656*5*555555*555566556777777*7777*7666777766544444444444*2232
444447666655*556655*5555555555566567677*777777*766667777*666444444434433223
44*67666655656665555555555*55*5*55*677*7777*777777666*77*66666*433333322455
447**6665*566566555555**55555*55566677777777777776666777766666*6433323555*5
