977887999987987898899877788*997*9878779*778*8799777799979999
89*7797789788888*87989787779798789877887**7*78*7887777788778
8798988979788899*9979997879*87898989977989878878779977979988
887877799878*999*978999798988798*78*99899778*998988978887797
7787979778779787*77987888799897989798987889987778*8987888798
99788978898987877889979777897998879*9*9887989987778877988889
79987988979889878999877779889797978*7797*8879879898997787897
998989**8798778998798979878*77*8897997998887998777988788*777
9988879999798778897*7787989788898878777*98787989988799888987
998988988899989898*98997879999997879977787987787898789977979
7797898799887*7897879777887887787988777877879878789789889*77
8998898778789877977878988879999897878989*87877*9799998788979
9777897999977878879787778888998977999778888*8*78989789989889
7897787777898777899887*88*87897997989879*9998777798787789797
989*797*98879798887989979887787897*7888798778997998897899788
9899877779887877988*98998888779*87888*8979897897897888887879
9777779879979977987998887*7888989898789889898788988777878977
88778779978797897898998777878877998988899988878897979977977*
87787788997779799*8879*798778877*978987897799*779777989788*8
79898*8789977997998779889877899877*897779777897897998*979779
777799979999889979*79788987899*79979*87878787788788797787979
9878999888998799799899989*779898997897779899898977797*789778
9878*7989778977987889888797879*9788987898987878789778989*788
877799*8878899788777988898*877879879**977778999877899888*889
778987787889898997888887979899887779*88888978888788*88878889
77977*97888989999787779977988877998*897888979998777778899979
9897798977999897*977989898977987799878979798888987987979*797
8*8799977888979988789*87899777788878877877879787898879778979
7*8789788888879889889987897787988799789977879877878998998888
9998877879998787898997788977799978779789899997979*877787*888
8978798977778887998878*99987898999887878*7997887798898778979
779989988799997*8987879897878799897*9997777777*8787979799877
7898888788988997898777787897977977789777789889988*7877777999
78799777778799879778*7898778879778987988799*8878899788987897
99799899989999797989978879778887979*9879777797979997*8877997
89999777779*7799788889897789978899*797877978997*779788797888
99898889999978879787898979889998978797998*977889798798978978
7799989987997779999998998*78878978889998998*98*8788999799888
8877788879777889877988977779789988977*879789887999*989877889
78988798988989897*898778898898797998877988979978877789888987
7979789799997799777798989777879979*979799*877898998788887879
789977799898789898989999*89*77978999*87788997799997977897797
989878879789977999797877897777988978889797878999778989988*79
9888998778999999989978977879*9877979888979979797799887787778
789887978979798897*877879897979989*87898*889*878887897988878
777*887777899989778998898878799799*77998878987*7897777999889
88987988779777988997999977777787997*8797897798797789888*8778
7988977799*87997988979877788*9989997997978887777889*87899788
*899978877779889999997*987999899998989778787878778*779788887
7799779889978797898899877779799978879997888*8887878789*89797
7898877*8879978878788898997978799898*9897*77*997987*87798977
*89997998778877897887998887999988889889798987799999789999787
9779987988889778798*7889877777879789778779987797778778979888
78987889777987877989887899898879897799978877977997777988*787
988798989989998887*8899897997*779878888778899997999779878789
897998779*897887977799898979878877879888*8777888878999999787
9987778787877798987*9997988797*7998778978*987988979899998778
8*88897978787999787978999879979888887799*9898898978787897777
777877877879897777877977798877787788*978*779*9799987887**999
8997*77988787798*987*7999897*7877888997877987897878879878797
