4*1114143*11132
*2132441421*343
314243443*341*4
343343324**3413
342131142114333
24*34433**2234*
122212343323312
322432243144311
42321*4**31*44*
*4243111422332*
211443241112222
23*232421344*44
41*314134**1*1*
*3341112*3*3331
4331233311*4313
