*123231332213231*23313322
233123113131332223113313*
1131133112312122331311222
3333213*222*3232333132212
2231322312233123211313111
321222123*222111313331232
121311321333123113*122311
3211*3332212333*22*133313
1232112223333321231121313
2*1133213111131323122*232
2223231323233221312211312
1123232213212121313121313
3333312113311113221232112
333313211311323132*3*2221
33*131132333*332232232122
131322*3311222311121*2313
22132223133*1323123313232
332322313211323311311112*
332312331313322311222*322
213211131*1132313123123*3
313222333233*331*22222323
3122333223232311312211333
3333313332113111131223112
2*12213211*132232211*1221
13313112323*3*33312211132
