44*444*54444554*5555556666*66666*6677777777*6666666666*6555555545*534443*43
444444454454555444**55566666666***67777776666666666666665555*454555*444*434
3344444*444455445455555*666666666557777777*6666*5*556666555555445*543434434
43454*44454*555445*555546666666**767*7776*766*666666556655555545*5344334*44
343444*4*4445444555555447666666566*877777766666*66*6*55*555555445534*4**354
3334*444444*5**44545*5547665666656*6877777766666666***5*5*55455*55443343344
33334544444445*4*444*55476*6666665558**7776666*66666665555554555554334*4444
*33344444444*544454555*46666**666*65877*7776666666*65555*55555*555344*33544
33333444444444*3444**54476*66666*66657*7*77*666645*5*6655555*554553*44*3444
3*33335444443*4454444455766*6666656568*7777*664*6444455555455*44563*4554444
333333*4*444344445454455*665*6666656657*77776454*445555565*4*44445444544444
3333*334444434*444444544466*6*56*5555688777764354455555*55554544454445444*4
2333333*44543**334544*45466*6665555555577774*4454445*555555555544*4445**4*3
**33333244*424433*34444446665*55555*55*566554*44*444*555555*54*445444534433
2223333334442343444*4444*4656655456666*6*6544444454555555555554455*44534433
3222333224442*4*53333*4*455565*55576666**445444445554*55555555*554344534**3
3332243*2243333*533343*44465555*4766666*5445*444455555*555*545*444344*44433
33332233334333334333*333454554544666**6555543444**5545545455455545444*44434
33*33*23*22442343433433344555*5456666654454434444445*555555455454454444**44
3333333*32222*34343333334*445554*6666*55454444444546*55*5554455554434444434
33333322233*3333343333333345554*76*665*444553444*465*6555*54444554434444444
33333333222322233433332333*4444566666454444434*45656*55455554445*5444455444
444**55432*2232*24353323223335456666*4*44455344446665455455*454*4544345544*
*555555*5532*2*224544323333354557666555*4454344*4*66555454*544555*544455544
5555**55555622223355443*33343*54766545554545344466655555555*5554444*53**544
455445555*5642322*555432223345435666*5543*45*444766555555555*55445553445*44
4*44**4*555665222*55442223*22233466555553545444476665555555*464465*4454*554
44*444445556556222*4*233*23323*3366455455545*44476665555555*55455554*344555
44444444*555544*324343*3323*22233665545455445**46*6665*554555445*554545**54
444*4*444455544521444*4332***2233666655555456444*66665555*55**44*5544434465
4444444444555464332444*23223444233*66555544***444566543333334444455*5543*46
4443444444555455422444*4332333432356665554455444443333333333333444545554545
43*44444445555644214*4443323333422366665*5*55544444333*454*443334445*555334
3*444444*5**54544422*444*432322232*76**5565555554344*45444355*5543334555543
*444444444555454442244*43433222*23236666565555*4344*44444365*4456643345554*
444444434554454444324444334333344332*666*5555553444344443455446666673335553
444443445544555544231*44*44425*33344*46665556*344443*4*34554*66*66666733344
44*433344444555444321444344425*3*33442*6656653*3*34444344*44555655666664334
4443334*4444444444**124*34442553*2234423666654**4*4444454*4*55*555666666543
4333334*4*4455444433314*4444255433322344223*3433343444344455555555556666655
3333344*4544444*4*43321*44442444333**2334222444*343444344355555555566666655
4333*44*44444444444321244444244433332222342**3433333443445*5555555666666665
4333444444444*44443422*144*324332334*44*32333334333*34344555*545*55*6*6*6*5
333443*44*4444**444433224442*44323*4444*43233233*3333*34**55555555666666666
**43455*33444*4*4444*312143224*23444*4444*3333333333334445555546*6656666666
44444*445*434*44444443222223*43343443*34444444333233333445555*5565*56666666
43*44444444433444*44333222223333334*33333333*4433323*3444*55545556566666666
*4444*4444442334444333322222233*33**3**33*33333343**34444555545666666666*66
44443334*4444444344*4231222223*333332344344444*44*432333465**555566**66*6*6
3433*4433445433*43343233*2222333333233333333**44444433444555556666666666666
4354444444*444343*43333222222*2332233333334455565665443336*5*5566666666666*
4*444*5*344*45*344433333122*22333*333333**4445*566***44345555*5666666*66666
*444455553345*3443334323*22*232322333323343455555666*544*45555*66*666*6*666
454*55544544454444*434333*23232223332323334445*555666664545555666666*666666
44355454455345544443*333322322*2*333233344434*5*56666664*34*5566***66666*66
4*455544*5*4455443434*33343*32223322222*33*445**6666*6*64535**66*6666666666
446555*4555*45444*434324*322*2*33*222224333454565*5666**555456666*666666665
44655543445444*5544444*43343*22332222324433455665656666654536666**6*6666665
4**555*44445*5*5444444*3*34222333222*22334*446665*56**66545546666666666665*
4465*5444*4455554*44443*34432233222333333334*555555*66666555*6*666666666555
4*65554*77755*55554444333444323322*3333*4334*56665656*666545546666666656544
436555467777556554545**434443*3*23*2*3244444455545566666*545*36*66666655444
5465547767777545644545*43444222**322232*3444556545566666*54554**66665*4*444
5465547677777*5*664554444*44*2223222*32434455444556*6666*555554666555444444
5*5*5366677767645*4*5544444422*2222223333344545556666*6*6*545634666*4444445
45355566777776765564554454*4223*5223*24*3344*445656666*665545*4465544444444
45355666777777774654*54445443155554232333334555456666666655455*33555*44*454
544556677777*777656*55444554*3*55*45332244*455566*66666665555554**455444544
645*5567776777*66*5554545*442665454*44222444*456666666*65555*55434455*4444*
653454677677767767565455544*26555453444*33445*5666666666555555*53*455454444
654544777667777*6655644654442654545444432*4444666**666665555555553435444444
664*4477666677**66666556444*26654455344423444466767666655555556653344554444
66553376666*776666667556444426654344444*4334446*776666655555556645343444445
**5434576666676*77*665564444*3664344444443344467*66666655*545556453343544*4
66544*3*67667677666665*63**4246553444*4*44444366666666**5**455554*523434545
