521425**132222322221*1112411151*3*1*11113111311223212221212*4112*1114111111*2221*26*122112312*1*2312311225212*2311112111*11123212*1*1*221*11112112321*
*21324***2333*65**5111112312*4*12*1111124*1432*222**3222112212**211*3111**111221*2***3*114*1*2*14*131*122212*61121121321111*2321*1***13***11233111121*
5213241122122**43*5*11*12212121221111112***4111243*3*1111141*122***221*11111111122212111231221*34141111*11*4312*111*3211111232*12*11132*111*2332111221
52**2311**2*22221*21111*3333321221111*132***1*111*2315411131224*4*23*111111111114221311241231*1221122*44*112*22*11123111112***1*11112211111123*3111111
521*2*111112211111*11111411*4*13111**115222111*1*22**1321311141111*31112221131121*2311*221*1222*22212222112*121*2123***1123211411112211*1*1*223211*111
422523111*13**11*441*2*15111411311*11*15*2411712222*2621141*2311*11*111142*14122111311*311311321**111321*3321111114111*1*3*12321*1****1**11*11111*1113
52262211121*22*121**2*11411*4***11111*1322**141*222343*1*2*14211*2111*112111*11221111142*211122231*1*1221231*12213*1111123112**112*111111***11*111*233
*2222*11242321113121352221114*2*1111113*12111214152222214*1141111211111*11*1*124*12***411312322**153211123*2*1123212111231123111*3111111111111*11*233*
*11222*22224212*312***141211*14*1**111522421212223***2132*1221122142*11*1*11114112*1*3113*15222224642111332121**2111112312*21121311111*111111*111242*1
42223221222*222131112324*21*2*4111*111322311*2312153***4112411125121111*111112311111311*2*211221**552*24121**222*11112421*22*11311111*11111****124*111
5*22322132251*2263*33414112312*1123112112211515131223123112*1113*22111111111141111122123112112123*32113221111*32111*13212411*132111111*1111*11**421111
42333*21*1251222***11**2***322*2134222*23**111213224113211*21126*****1*11*112311111411*11111313*431**312*11*13*1111142*13111*321**111111**11*124211111
326532222225**1232211*22112222111*2432*241142*13342*114112*1113*41*1*1*21111411111121*2*11122126541*2**2**2**21111132*13111**3111111*111111112*21*1*11
34*53*212124*21532*12111*22*22**2112*2122*2414132452*2*1*5*11*4***111112*1*2**11113*13*1121411235212422211*3*1111133***3111*31111231*111**1113*1*111*1
43534222*2241212222*11*1*23223115512*2141111213242511311*411*1413111111111141111*2211**22141*53221142*11*12211111241123111231111122111111112331*111111
4242*2222223122*324411*1*232131243314314*1*12*1133*112114*11*21111111*11112111**23*14*112211455211*122112231111122212*11*3*1111*31111*2111242111111111
42*2**2222331*2432122241122122222121*2211*325115*41*211151*123221*11111111*111114114222113124521112*12121311*1114**3**11231111241111121112*21111111*1*
32524*222*3224*2221112*11*124222**1422*11212*22324114*123111*6224111111*12*1111521142212422*2322*633112331*111242124***12111113222211111*32111111*2211
425242222242211*2224222224124122**15*141131321*232*1411**1*31221*11111*11*11112**1212**22143*111*22*1112311112221241111*111**2125211111242*1111112311*
325242221262*22421*724212412312*3*223111121**422*11121*3*112211111211*1**21*124111411112*245211**1123*131*11*23*1311113*111*321*2111**2*2**11111**1111
42524*2222422223222425*22**221*71*2*31113113*5233*14*1*21*3423121111*111411113*11*112131*5*422231212314*1**224*12*1*13411112112112111*4211111*11111111
42524222*252222222222442*214*111*242*2*2*1221*2*11141142113211*1*1*111*22**12411*2111*1135521132113*132111*14*123111342111223*2*11*123*1111111*1111221
*2525222**52*122224*242*422511111132*41*21411*431131*3211211411*1112112*11*241114111121123*11*321121*311112*21232122621111112311*11233211111*111**2321
*252*2222*52212*25832222*223111*23232214*1*1425*1*41151*1333111111*1123*1*132224111221*6221132*11*1221*112411221123311113122211*11242111*1111111**3*11
324*32222472*23*11233*4*2*3221112*2*2113121*323112211211222111111111***1*1*3*121**142224**1241111*1*211*1411*21112*111111261113*2*421*1111111111111*11
2243*232222*12422*32434*222212*1232*31*115142321151121112*331211111115211*11114*1*112*3*222*1111114***2121*221**142111112*11124534211111111*1111111111
*253*3*5222222523*32522522212111**5*313121*525112**141121462*3*111*1221**25113*112**3662*23211111*11111*4125111132*111*14112212422111*111111*111111112
*2*32333222222*244325122222212115232*1*13114221*4**1*11*3**2224211*241**1*112211*3125772*13111112*1111**213*1112**111*1321141121211111111*111111111132
**54*2332222224*57325**122*2*2*242241221*132*112411321212**1*1*321*1211124114112131*474***111111*11111*22311**2*11111133*11*111211**1*11111111111*1421
2254232*2222*232211232*21*111112*32412113142311221151131121*11*6521411**42222*1151232*2*22111113111*142112112141111*14*11142*1*21111111*11111111124211
225433*5**222322352312*222221124244*1*1413*24125*2321222321**111*12****521221124**1342132**1*2*211*23113211132*1111252*1241*32111111111*1111*11232211*
325524552622242235252*222222*1241451*112142311221141*123311*1111112*112*12311232111121**11111321111412*311123111*12511114*113111*1*11112**1*11132*2222
326432232522**22*3*5**22*7221114*2413121232522412221112322112311124112411*3113311121113111112*111*411*3*1114*11*1242*113111**1*11112111321111*223*11*2
22743222252**52233242**12*11112*222221*2*2321231142*113312**14111*412421151**41112*1*32111124**11*2124111241111*142**2**124**111*1111*1*111113*122*311
3*643222252224225223212*33111121552311224*52142*221**2131*11**11**1*221*21*1412111*1*2111114111**4**41111*11*111221*13*1131*1111111111111111321123*122
32*5*222252223225232*222731*12112*24*112223*14114222271*11*1111*21124*1141**21133*13211*1*4**1115215211131111112*11123*1*1*1*1111111*111112321**2*1123
**652222252223225242222**22111122211122434121*1**123*21111*111252*1121241123111132*211111111*11522411112211111221112*1**111111111***111112321*11**1222
326333*3252232226*5*21113*111112213*1423*511211321*42231*1111111222512**1221*366222*1111241111*222*11*13*1111*21122**1221111*111112311112*211111111221
33633332*4224*22335365*23222211*11311232*22241*31113411**12121322*5121*122*121234*121*11411*2521*211142**1*1421114221*111*111111*111*11**1111111111111
4****342*22252232*222**2221*22**1*21*1*3521131**112431*111214*3*1311*41*1*212222231*3*151111411231112211*12321*12211*111*1**1111*111*142211*11*1111*11
44632232*22*6*3422322*342*2212111511*1223123**4117**2*21*11222**2211221*41145*22*22222*11*132*2411*2*111113211124114111*11*1111**1112322511111*1111111
445333324222524532*222342**42221*3121225112*132*216*131122*122443*1141*2*11122****41**2*1*23125111141111*3211*24124*1*111*111111**123*144211**11111111
*4532**242223*2633**22*52232245*21151225*1211421223*22111122*21***2*12*4211*123123***1*1***114*11131111212*11242131111*11111111*112411121*1111111111*1
334*2422522222233*4222652*521222*1141422113*221114*122*23*11411112142251*32112122311*1111211421123111111412**511211*111*11111111***1143*111111111111**
345325226223225*236522552242412222*21*3111*1211*73232323411142521114121112422213311*11*123142111211111141**161*211111*1211121111*2*1421112421111321111
**4224236225235*2322*32*13*2212511**32212312*121222222*52113121222*122**11233113114111132251**13*11*14*13153211111111111**2*1*2*1*2311123211*211*111*2
433225*25227226334464422242*2214**1252**13242**12*22*12*11223*112*1*52*12321*511142*11221**111421221521114311111111111111121*1411231111332*33*11111111
3443*5325*26*242335435*224256424*423232122251121**21225212521*11*3121112**31113142*1***2231114122124*12223111111211111111*12333232111123123*321**11111
3*223*34422423224322253*2*264242142*14112233122312*3322112*4212141*31*1*443**3**21*12*22311142212122*32241*2**1263111*111123221*2112*2*11*4*42111*11*1
333*6222332334*2423323**32232*4*22**21122241*23632322411*3115*13*1321***2212*2141112411*211*1*2212113*3211111111111221*12*411*3311*132111125211*1*1*11
33333*2222*2353*53*23222*2222322***241231231242222122*11422112722*4*223*42222241*1251*4211321*2*12*25*2211*1111111*322112211*3211214*1133*1112*1111111
332223222242244344*332*333222112223*311*1412242*4*2131125*1*21*215111325*22224*1111214*111212**2*2**26211111111111321*122112*211123*112145212311111111
32*432222*424373343**3**22323222222521212*122323222*412*21*12*2*4111235*1122*31112*1*21*14122*1412*232*11111111*14111132*1*411112*111241*2211111122**1
22434432225233533444433**32342222*2*222*42224*221225125**3111*1311112421131*21*1*513211132*2213*1122111*1211*11***1*321*3411*113111*242123*111111*1**1
32*442432*6*42*444456424223545222*3322222*433252222**2324**2222*12232521221311242134112422*2151*222111111*111123*12*21*22111113112***322*1111111111*11
233333*24242*274*44444244323**23332232222213224*2251*5*241342*711*232*11*241114*4*4112*214*2*212*3111*11111113311251*123*12*22111421143311111111*11*12
22234423354**35446**744*33232*3133323222222125221322*3252132*4121*4331141231*24223*12*1262351212412111111111221*14*1*421111411*122541*21111221111*1123
32323332354*67533453454**22*22*223**45222**1221225213132142234211326*14113*222*12*114**1224*1214111*1111111*11114*1*4*111141121*41**2211111231111*1331
3333422*32222224475*34**21*2*222*1335452*22*2221*212*25*343**23*2541122251223*1251*321*212*1124*121*11111*3211*411242*11231112*2**1211111111111112*22*
643*3*43*544422246*4**44221*44*2**2*33362233*22251241*224242*2624*31142512*3*22511422*213*2144*111*1121113211231*24111112*2*12332311*1111*11111134**11
67*55464*357454454564*44323211*23222332***3321262*2*22*542*6223223211*511*2*2242231*2126223*511111*111114112*1114111113111125242211*15*11111122311*123
8545446677*7554*564**66564*24*323225235*32*643321242**4325422226*2231522122223223111124352332*111111111411331124111123112*11**211111142*1111*321*11331
545*454**5787**7765736554*33*222*22*343574224322232*233334322*5****352222*3*6224*1212*332*22111**11**241*32212411*123121*14222211*1111111112*211*24211
756654336556*65**4676754**4334422*232342*5523642*2*334432*32333422*2322252252251*21112142*211211*11*2*2122123*11113*1112132*21*1211111111133111*231111
8864654*446*456575**577*75743245*22*7*3323*865232222233342*37742243*2*341331*3**21213*125212*2*122*1*11141*42111**11**723311*112621*111224211124**11*1
*655763*44566566*8*775*545***32223*3243345322222234*2443424*234*52*313*2**32*21*21163244112111*221*211242*411111**2232*3*41111116*112114**1122*1111234
*7377*54474657465665767*5*64**322223*33334432233*243*3444*53342324*22512*223*112**22*25211**1121112123222*11111*1113*24321112*1122123213*1**4211*22*22
5677774546*5764445*855477776634333332374*4***2**22**3*23*4434*244*2*4122*223222*225344121111*1122411*22*411*11**126*132111124*212123*411*135*11122211*
*465777576*6786746767*7776674*434*42*26454434**22332**34*364*3*44332223322222**1*22*32221*12212321*2**42*111**233223312*21*123122*4522213221121*12342*
5575467765454567*5**58454*4457437*333224*544343232*232337*44345*3*33*3325222222533232212112**2421111232111123*325162213222222124233211431*11112*6*4321
554*337746545*5755*55567444564652**3*234435*4*2332**334*435444444342*62435222242*24222*222121411*31*411111*3*45222*2*31*22211332*32123*121*2**522423*1
34**5555*6454444647554*7764443454453***455*445522232233454545834**4332*22242*3242*22*222*22*41*23*2*211112434253*3112114111122522124411112211662311111
*53*5*45576757555666555556644464354223224444354*3322**3*5*5*64654343*512*224*332622*222*722*214*1221*11*2211522**11122*22*123233124211124122*45321*113
2354457**5*78566775*65658855643434*4326444*4644**334*35*577644*64433622*222233352222222*22*1*42*2411*213*1*224222*32243222112411*41**1321*42**2*1*1332
445645**7*45**655*677666*4*64545343436*352*3445454433*24*44**43*5433*222222633***222222225*143*35*11112211**231*12222211**1111*42*11241242223*1112421*
66544544255*6*4*56*46776776*664**44*232*34*444**4424223334*4354453*32222*2224*2222121**3213312*21323***11*11**12243*211*1241*31*1*442131*3*21*1321*114
4775444*44485**456**6557776766*44445434*454*7474455*243434*5536443**22*3222*22**2222215*1*113322****211421*11233*31122*24113211133*124125211112*2114**
5555*4*65*5475*5654*76465*7*7**6466445444*54*664645452443454*4334532222*522**2*221*22521242*323*222125223421242251*62222124211232124313412*133122232*1
77546334446*44535476*6767*68766*6**5*4*33*44574454*5*3323*544434422222*2225*2222252152132252242115**22*12612413212225*11312122321*311421*123*112221124
*7755664444*3447*5557*4875678*6746455*43*5254556444334443*23*5443*33*5222**2321*32*4*1*22221421331*4*11**321*321112432141112321*321331112*21*122112553
33*7645543*5644345*56*7555*666*764765443**335656353344334*3**484443354*33224*22*23*11512*32*1133*141**11*1234*234331241211*3**4422*11214211*243*11233*
65*6666*334456434*65565467*5**7656745556335*4665745*24*4634333*44*34*****2*22222323*525322412*2114*11111*112*12531114112251*14*242111131112*31*1*11232
4*44*54764*22*3434655*566547664777566445546*6665*5664*632**43545444*33643232222**12*23**261*422*411111111111111*2**4112121134*142**123*2*44*111*111121
4364434454663633333435*766566766767766544436278557656555446*44*4444*3*344*2*225*122262*42*42*242*11*1111111122*13211133*25213**111*3111423211111*112**
33*4*53*55566444346*463**7**4*66667*6665455*4588656*45**3*4*35454443533435434*1273**1251*42*251111111**1*1212124*112321151*3211132212*41*112131**111*1
5434444445666*435436*36467*666666*676644555*343675634233211225554*4323*3**7323*2222*13124*1*31111111111111111421*1*21142131*112321113*21112**211111112
33*44*4*433345*444*4544766*656767675*54744*45344332343*3*212235*4*335333*43322222234*122115*111211111111111*411123112311**1112311124211112422*11111132
4345334*6*664535**3*43*46666466667566566664*4*33*435*332232312544546*46344*452*3**522*211422111212*1111212321222*1242**21*12*21123221**242111111*2*2*2
354444*55666*3436334344*444566*7685*6*665**45234333*333**522225*64*3443333*32322*211*2225**2*1*241*1*241141124221432**111*321112*11111321*1*1231*32112
345*564*465664553*74336456665**6766*67*6*7***25*36*3*3432232622*553344333**32232*324123*21*2*2221****3*24*224212*21*21214211*14211*1341*111111**11*121
33353454*5556*76555446456466646*6*666**6675654344*4533*3322*4244*455434545*3223*32422332*1***312243125*2**2123*21431*232**13311112**11111111*23*1112**
4433343554*54767*6564*464765756767767675345464*553545353*4*2423234465*444433*2554222222121221132*2224213411243214*2232112*41111243111111111111*1122111
344334*34535*65*7665*43567474*7**6656744464*3666444453533*32723255536*44435323*33323*218224212*322251142112322*2224*11124*11124*1111**11*1112123211123
3*34*4*4*355*4456*56576445765*7776**546564*44436667433*45*42333344*544345**3343322*25*4452*22233122152*1*421353*222112521112332*1111***1*111122*213233
444**22343*43355*75667755457*7777*65*56*547543644*4344353*332**24**754*54*45*34*52**23*1132**113322*321142252223*2123531*1*321211122*11*11*1211233*211
33442332*533*3*445**55765556*877*76*66546*54534*36353333*3*2122324**66*533743333332223221232221142*1142323322351223321*13321111*111111*111121343311212
423222*33445*34453*7**57767678*7776**65*66454344333544244632*323345*465766445433222*22*112233*1321111222321143*11*2*112*211*1121111*1*111*3234121*21*3
*222332234333334*54567577778588878**77676454443*43443242*3443422*5*553545*44444*332222*2222221321222**3321422224511214*2111142*1*1111*1243341211*141*1
*222*232*3*53*33**46446677*56778877764*65*36544633*34*53343337333545464455*5334*3*2222221222*212***111261212421112*311113411*111122122333211*2*5221112
222*2322*32224343*4*5**5677877777*7776756*7*4434444343335*363*3*24655544**45336*433*2222*2*22**22131112511324**23*211*1111111111*2433441111243*2211111
1*2*2*53333*2*4*34*533*45677877676*666*65756*544344433335335344324465563575454363322222*12222*5221611*1225312**4211114*1**111122232*222*234*222*341121
22*2112233232232*343353*536767*76*76*6667*76555*4454432433634332233546*45774*33335**3222251121241141111182*11*2223*211*111111223*2131114*2122364232215
111111***3224324325233**354557757776675*6*77654455434622534445342346555*568443533*232222**2311241214113421111154141111211*1233*41121243*1*212465215341
*2112*121233*22232233*3*3*4*7477*6657*77**665466*55553333334544*2273655446444*33*5532222226*2222*11*1121111*111***21111111*3242212332111**12**56*122*1
11111111**12*32323343*434***4*6*767565766*56*6554456343433*43543*234*654774*533524323*2211132*2244*3321**411*112*111111**2**2211441*121*14224244211111
2311211122**13*2234***3**3334456555557455666656556543*443*3335433*246656465344333*34322*21121212233*23121232*11*122123*42**234221111*221*2411111*23232
4*242212*1**21252322*32232*3*54*5667756*666654**5453334342**354332*35*3*5665335*3*32322**12223*2*21124212*321*1*1*212322*134222121123241412112*4122221
2322222211112*1*53232*3234*2*33346667755*66465*654543***2233*6534*2*44*57*43*4**443323222221441221522112**61211**32252424*2121111*11432111113**31*1112
**13*3213221122122342232**2534335334575654**6**55553634333*433*4436*64675*464*3333**33222232411***6*1111**2*111112213232*211*11114112111241*1422*11**3
11*1*2222221112**232232**22233332*534575757*66665465434334*2*44*32336445755355*24343433*22*42*21211111331*111111*21**23111121111211111*2132211*2*332*1
11111112222*2*11**233243*2224434322*364574555566*53533*43*43234463335*64575443*34*332322*22223212*12442211111*211223321*22**31111113225*14121*42221211
*11**111112222*1*112*32*23**33223522*4544*545646565343334*43324435236*57*675*4463323322322222222124421222111111124411*14112422111*23*22111243*22111*2*
11111111111111*1121*123223*22223223*33544664***6546334533*3436*5622344*8*86*5533*23323**2**3212*332112221111*12442113211**12134223*3**11432121*1112*21
11*1*11*1111111*12211112222222*423*23454*4664**566**66443*53335333*4445354464433334323452*1*32132222272222*342112*21111*12111*2111*13*1111*21123*2*111
*111111*1*111*11*11*211*23*2322244233345*44666*65554554444*3233433236464**34445333223222232252223*2314212221213*2111111*11211211*4322111211233211***22
*111111*11111*11*11111*112222*322*2**32***455*75446*464534632345343246567435734*33322*23222*22*22*1222**3213422*1111*11111211*432111*111233221**1233*2
*11111**111111*1111111112122222324*3*3**35*43565*6464555434*233*53344474434345**3*4343*22222**22*22*4252*321*11111**111112*111111*111*4321111*23332111
111111*111*11*1111111111111222*222322224345543**66444**433*43*3*73445555**56454333334*23222122223*13222212111111*1*11111111*111113443*11*11233*2311111
111*111111*1111111111111211*2*2*322322223345436645**5*445443*3*53*5*664**4*434*735243322*2*23222122*31222221111*11111111*121112*211111114421*222511113
1111*1*11111*1111111111211*1122*122322332**35*65****56443*343*6376565646*555475333223*32*22222312422212112211*11111*11*111124*211*1123*2212333**122343
111111111*11111111111111111111123223233323*34345*545*66443*334437435545445354464*2232*322252123*222*54*426*1*11111*112*2*31*1112331111*3*111134321*1*1
*11111111*111111*11**111111*1*2*2212*222243344555354546*44334*3664*535445634644*322*32**322252122122241*14*1121111*22*421112243212343*1113*43211111*2*
1**111*11111111111**111*111*11131222332223434635*5345*46*4333344755*4344345355*4433*2*2224122*222222*4113*2**2112344311113*22*24321*12**212*111111***3
1*1111111111*1111*11*11**111111*22222233322343454445456**4*3**33*3435*345364*5544*32333424*31**222221*22311*12442121113*22123222123*3*11*11*1*2*432111
111111*111*11*1*1111*11111111111222213****23334544*4336*644534335*4*45235*5334***226422223223*1*2*211*2132244*4211*32*1243*121*33211111111234421111111
11111111*1*11111111111111*1*11**12222*21*3*32*6545633*4665*63**54*4633223*44*5532***3*24232221*4322222*134112242322224422*3453211111122443221111*1111*
*11111*11111111111111**1*11*1111111*1235222234445333445*7543*334454*44645636*442222332*33222211233221252111422*12**22222321111*1222244221*11*111111111
1111111*111111**1111111*111**11111*1***23*322355534*3535*5533433555546*54344654*2*2333222222212*36**112*14*6213*322343211111122*5*3111121112**1**11111
1*1111111111111111*1111111*1111*1*1*2222*232343445*554665453644*3356454435*5533322*34222*2233*1111*2*244*22411**21*12342*4542*1*1111111*111111*2244321
1111111111111111*11111*1*1*1*11*11121*22223*234533544667655634*45346445*5334562223225223322223*24223411*1*3522123432112221111111**1111111122343*1*1111
111*111111*111111111*11111*11111*1*11122222*2**5333544**5453335334*4***5453*4422232332222*2*2331*122*112*1223542111*243222211111**112125*3322*1111111*
111111111*1111111111111111111111*111*221222**33*334*34576443345435565644544*333222**32322*2213*2*222352244**221*24431121*311*11*2*23321*111*111**11111
111*111111*11*1111*1111*11111111111112*1221**24334*3*55674**353555*35534*4*4332*224*3322*2222332252214*2211124*21211234*13*22233322211121111*221111111
1111111111111111111*111*11*111*11*111112122*2324**344456*5**433545*44*5445*3*3443342242224122234222112111422*1**1*5****51**222211***211241*11111111111
11*11*11111**111111**111111111111111111*2*1*2323445344*77*4*33445455**543554*2*24345122322221232222*1*5321121342134*3*22*1421*2212432111111*1111**1111
111111*1111111*1**111111*11*111111111*1*21*22532334*456**5*645*6*644*4555*423433332233332222321112*2*1211*11***11334111*11111*4211111*1*11**11111111*2
*1111111111111111111111111**1*11*1111112*222*4234444477*45**53465*63**33*4342224332*354223*22222*21*22111*12213111*1111111111*321111211111*111111**2*2
1111111111111*11*111111111**1111111*1121*12*23*23364**56666464**4465476444*23*4*33*433432*2***22*2*25*1***3*31212*14321111*111*1111111*2*2*224**124312
111111111111*111*1111111111***111111*111*221*32434334*77546546*35*65**6652434*33342*2332*2**322231*253*223222222*2253111*11111111112222*33*22112222211
1*111111111111111***1111*11*11111111111*22122*5*2334***7745434445*7*4*4*63*423334433223225323222221222*22511223*31*1111211211123*4432**11***11*1222333
11*111*11111*11*11111111*11111111111111112112*4*3533345774746454677556*344*35343*4222*3*2222222222*121*32363222212*222*334443332111211*1222*3444222211
111*1*1111*1111*1111*11111*11*111111111112*212334343*356***7445*46445464*433*4433*3**2*522222232222211421222*241*4274234121121111122334333*2**11111112
11*1*111111111111*11111111*111*1*11**1*11122233343334545657755*6**456*4633**455**33223*5322423**76221*22*2212*3*2322111111*2234543211111**111112*22***
11111111***1111*1111**11111**11*1111111111211*2*3336444*55557*6*65574453334233*434*324343222*321342113*112*12*23*345*543*21*111111221*112111*112222211
1*11*11*1111111*111111111*1111*11111*1***1211213*3433345454477454**44444*544*7543*33*235222*33*****2222*2345*421**21*212222*11111*1**11*2*22**22*221*1
1111*11111*111111*111111111111111111*111111*11222*43554466*6676544543534465255433*3225**3422322222**223*2*222212*22*1222211*2**1*1221222*336632**3521*
111111*1111*11**11*1*1*11111111*1111111111*112222***4344*44*7635*4**345*434*4554543**32**32324222*11*22111*22*12321222111122**33444*3322343664*1335111
1111111111111*11*1111111111111*111*111111111*22223*4535543437654*54*53543233543**3*333332*332332322222221232*1225213*4453*22221211*1*11*2*266*112321*1
1*111111*111111111**111111*1**111111111111*11*12224*436545447644443*2323*224*444433234243523222**223222132***1*12122121221212*2122221221222*22211*3211
111**111111*11111111*1111*111111111*111111111112*3*3445643**555*6324442**3224*4*44**333333*3322222222223*2*32212*11111111*12**233443*253322*2*1113221*
