9988887878*7887998*7*798877779978889787797889989899897999788
9877998878987788888997799899*9899979998878997789977879778798
9997*88778978898797997797787889777879989978779779798798*8797
7797*889778988777978778797997779998877999*77889798899*877897
788977*78887789987778989779798787877979977989899778778888879
7*78887987977*77*779779*889899998999978899979799999977897987
79897799877899779879797*9777788**999898887979878977887987988
997*79789978879*7787797799*78877787899797899777*789799797887
87977987**89977799*8777898788777789789899979879777887778779*
977988987988897898879977978889997879989778897978977998987887
87898888788888887778797989788887979797978799898997878**98877
997788*8888798*7977*99888*897979977798787*987879788787878998
997779789998988799988778779898878787799878997*99878998797778
78**99879887778*897978*789799779*997897989787888798878898999
979787897898977789888797887897998987979978*9899788788*979877
778799988889987977878779897898888*79897797799889777898789788
79978889898877989998899978978879998878978777779888*977899978
779977777977997989789778789989987998998987889998*87988*78978
7999788*87977999977789887899*8979977997999898*89*78977987879
9888879888989988797979**87*789787888998897877*978989*8888789
99*9889779889*7999779989798898997989*97797877877989878877879
979*778798999797997898998979797899979***7997877878*897888*89
97888997797979889979*7798998998*8877877998779*877799798989*7
77879*87998*8778788889979978797789997989*99*8*77999887898889
999897989899989788877788*8889987878798799*897999898877978779
98879797979989779789889788797897887989*877798779998898789978
97887998987989898879888978787989777877988*778878897878879777
*7897899*978*8979978878777*9887*7897989988897888989879988977
87*98787*78778777778897897997877989889897798879978788997*789
98998787987899877998797778999897988797*87*778877878888988989
77*777879887977788977878988899779999897797889897788*877*7788
99979778*7779*9879887898978*877978*7979898988789998798879788
77799778977779987789998999977798788889998888778788*779979797
*9877998777778779788979888999*987998*79987877987889889*89878
989897899*8777887797*999979798899*997878989998*98879898**77*
997*98788788877978888797788997989*88789989777998*97899798899
897879978988798887998898977979777887798989799887988988898978
7888998998978897889*98899977877877999999997987999787997*9898
7877987989*8898988799887788778788798979987779889877897997998
79878**977*7998788799798*998798877777889999979897988778779*7
9887799878997999987877787998898789879877777777*9997798879889
7*997799877788777978789899977*899999978998899778877887987778
897*7988978879789787879799*987*7779*988878777988989879988878
88779979797979997*889978787797878787998987899879788787797799
888989779798897888788879787797998998897989978878889798898778
877889978987798977877878898877898988789987989989798799988989
8789787977989799877777988978798879787*9798788879*87978889789
99789778979899897899*777789799898897999798978787787879989988
98877898887787787897877899778998979897*789987988898997778888
8777887999798978889877*88789*9798889988978998788987887999798
799897888979779779778*9779*79798888*899988798898797*97977797
887897979879777779998898778997797*78778877799888879879989877
79898*998998988887988898978999877977778799797999887777978988
888877897989778978898877889998878898779997899989889979999989
9899979978999889798799979998789*99898888889879779987*8889887
8787*77778798788797889798978789799*9987789889878888997978979
889*87888998799787987787*89887897798798879887899978878998988
8977978989789897777*977*9977998787979988*879889*978899*78788
99777779997989988779898877*98788978798898888889787*799997798
88987898977877997797799777898*987899*98879878999779987877878
