1233232323
1231313312
3131*32113
2312112121
213*333313
1311122111
2123332223
3333*1322*
1222213111
12313312*3
