3323423*422344422234
*2*33322442432*3224*
324*4323**33*3432334
4222342424*234334333
422*324*32333242**2*
*342*3242424**43*4*4
223*222244342224*333
442433443443322*3233
*44243222423*44*4224
224*324**3*32**23433
3222323334424*42*223
443322*2224344224*4*
232423224324342*2242
3344442222*2***32423
24*3234242*22343243*
434423333243423*3443
42422243232242*323*2
224422332*3422442334
2434322443**3*34223*
434322443422*4434443
