13222313*34122*
321442422244243
322244*244*4243
21*3413143132*3
1214433223*3433
421214444241*24
231341*34223*43
444241444*24114
321421433**11*2
*33112433*232*2
323113433343243
2141232*42114**
3114341331112*3
4**331321121344
*1114431*212412
