3*31133331
2211333313
3332*21213
3*1*321231
121123*222
3322233212
2223312231
3313322112
1211232312
2233123221
