23232224233223*43*23
33323342*2*33242423*
**32*424*24**4332234
*42*322*32223422423*
*222233*2333*4424234
*4*34233424332343223
**4234*2322333443*32
2324224222323244344*
334433234422223*4*34
234444444*434*422443
2442*423423344434324
222343342343333*4*43
443*34223243232423*2
44442433434**334**43
*442343*334424324332
34343*43244*22324334
*3*3*24233344*2342*3
34244423344344*34**4
2323223*3224344424*4
24423434*42432*2*343
