1**244*41322233
*41431*12144322
3224*1421422441
413112222431442
3233122*3*222*4
443234332**44*1
1111*1244122424
12413*342423234
323132221313121
423321143221321
2122*431*142422
442322*4*413143
214*41343414*22
3122**1114**323
3442*3322124321
