*311112331
*231323221
22231*1313
3313*21233
2121111113
3312213122
1233321213
1111223332
*313313223
2122123331
