1111111111
1111111111
1111111111
1111111111
1111111111
1111111111
11111*****
11111*****
11111*****
11111****2
