34431331422122*
222432214*312*4
4114212*413*442
33*1412*3412*43
*3442123124143*
31*223*143*2112
32112*313214331
133442*34222233
333*33411412242
3*4122213331242
313321*4433*243
21*131221432212
2424*1142244112
314411*1423332*
232121*4331*141
