*342433*334423422343
42*443*2342*32323*32
24*223243*342*223343
4242**24434323234344
32432333**24443*4432
43*23333*22234244234
422443*3*2224*44223*
***444**4434*434*23*
*444*24423*2242*3232
23232244422242343344
33*3222222*22*324223
**2*3242244234444*44
2*323443244322322244
234332434233434*3343
3444*233334423234324
2243224333324*434334
4444434234*432323434
322224*2322223*4*2*4
*4332334242422*4*332
*3332333*4*434*34233
