323224*334423*344222
2*223344*4*3**432222
33323**4242*223**23*
224342224*3*23*44322
34243222423344234322
33*22*3323443444*344
44323432*43*34334*4*
4*2433444*4432322344
22**3*444242322**442
3*434343323222324443
23*42323243224*333*2
3334443242*4223**2*2
44*33242243432222422
3444232*44234*32244*
332222244**242*24233
23*4*4*2*4*232233344
2*22224233432434*342
22*3*423323*24244233
32233422424242433222
23233234344344343332
