2312123332
121131**11
3111322121
233131*232
1113213213
1323111333
2331333111
3*11311232
31*1323133
2221312132
