55*5*54455
544**44555
4544*45545
5445*44554
55455*5444
4444544555
4445545454
4545454455
54445445*5
555*5555*5
