3*13233*1*32*2*32132
*3323112*222211**321
3*212***32*13***2121
223***1*2323*1*13223
**112*133*12131211*2
3**31*****312*1222*1
**21312*213122212333
22311*23*3212131*3*3
1*3*133*23*3132*3121
133*12232222*3*3222*
2*32111*1*21*211122*
3*232123**12323*3213
33**2**12*3**3*3*132
233213*311112*333332
**23221232331*3*3*21
3332221*3*13232122**
322*3122**2213213222
2211**32332113**1*1*
*111*1133111332213*2
12333223*2*11*2***21
