....................
......*......*......
.......*............
....*...............
...*.....*........**
....*.*.............
*................*..
..*.................
........*....**.....
..............*.....
...............**.*.
......*.**..........
....................
...*..**......*.*...
.......*............
.*................**
..............*.....
...........*........
..***.............*.
.....*.........*....
