...*...*..*.......*...***.*........*..*.
.......*....*...*........*........**...*
...*......**.*....*..............*......
.....*.......................**..*.*....
...*...................*.....*.....*...*
..*.....*.............*.....*...*..*....
...*..*..*......*...................*...
...*...**.*........****.*...........*...
........*..............*................
......*............................*....
...............*...............*...*....
........*..*..........*...........*.*...
.........*.*.................*....*.....
.*......*....................*..........
...............*.........*..........*...
.*..*...................................
.**..........**.....*......**....*......
.............*.*...*........*...*......*
........*..*........*.......*..*........
.....*.....*......*..................*..
........*....*...*......**..............
.*...........*......*..***..*...........
............................*...*..*...*
......*..................**..*.*........
..*..........*.....*....................
....................*......*..........**
.*..............*.......................
...*...............**.......*........*..
..*......*.............*.......**..*....
......*........................*........
*.........*...*...............**........
..*.*....*......*............*..........
..*.........*.........*..........*......
.........*.*.........*.*...*.**.*.*.....
...*....*...*....*..**..*...............
*..*....*...*..........*.........*......
......*............*...*..*.**.*........
.*...............*......*.....*...*...*.
.........*........*...*.................
.............................*.*.*...*..
