..........*...........*............**.................................*........*.......*............
..............*......**..............................*..........*..................................*
........*.................................................*.......*......*..**..........*..........*
....**........*...*......*...........*.................*.......*.*..............**...............*..
**...........*.*.....................*.*................*.......*...................................
...*.......................*.............*..........*.....................*.........................
....*...*.............*..............*...........*........................*.......**..**....*.....*.
..*.*.*....*.......**...........*......*..............*..*.*.*.................*....................
..*..............*.....*..............................*......*....................*...............*.
.*............*......*.......................*.*.........................*....*....*................
........*.............*..........*..*..............*........*................*.................*....
.........*...................................*..*..*.............*.......**..*.....................*
..........*.......................*...........*...**........*...............*.......................
..............*.........*..........*...................*...............................*............
...........*........................*......*.........*................*...*.........................
.............*...................*.............*..*......*..........................................
.*.......**..................................*.............................................*........
.....*...................*..*................*.....*...........*................*...............*...
................*.............................***........*............*...........*...............*.
...............................*.*....*.....*........................*.......*..........*........*..
..........................***..........*................*......*.........*...*.*.............*......
.**.*...............*......................*..........................*.............*...........*...
*....*....*......**....................................*................*................*.*........
....*.....*.............................*...........*..*........*.*.......*..*...........*..........
.............**....................*...*.........................*....*...................*.........
..*................*............................*......*...........*.....*.......*..........*.......
..............*..................*....**........*.......*.............*.*..........*.*..............
...*..**....*..*....*.................*.*........................*....*....*........................
......*....................................................*.*........*..*..**................*.....
......*..................*.......*.........*......*..........................*.......**..*..........
..............*.....*..*............................................................................
.*......................*...........................*.........................*.....................
.....................*....*....................*...*................*...*......*....*...............
........*.......*.........*....*...........*.....*.................*....*...**.......*..............
..*......*......................................*.........*...............*............*............
....*........................*.........*..........*.......*...........*.*....................**.....
.......*..**...........*..........................*....................*......*.....................
*........*....*..........*...............................*........................................*.
..........*........*....*...................*..*..........*.....*....*........**...................*
..............**....*....*.....*.*.*............................*...*.........*........*..**.....*..
................*...................................*...*...............................*..........*
..........**..........**.*.......*.................................*...................*....*...*...
..........*..........*..*.........*...................*..............*..........*....*....**........
........*.....*.**...*.......................................*...........*..........................
........*................................................*...*.*..*..............*........*.......*.
....**........................................*.*..*...*..........*.....*...........................
...*......**.......*..*..........*...*..*.**...**.......................*...........................
................*...........*................................*..**....*..*...............*..........
.......................**....*....................*.......................................*..*...*..
.........................*................................*................*.........*..............
....*....*........................*........................................*...........*.*..........
.............*...*...*............................*.....*...........................................
........*.......*......*...............*..........*.*.......*........*.....**...................*...
.....................*........................*.**..............*...................................
........................*............................*..*.....*....**...................*....*...*..
............*....*..................*.......*..............*........*..*............*...........*...
.*.*......*.............................*............................*.*............................
.*.........................*...*................*..........*................................*.*..*..
...*.....*............*..*............................*.............................................
..........................*.......*...........*.......................*..............*...*.**.......
........*............*..................*...........*......................*...........*............
.......................*..*...**......*............*............*...........................*.......
...*............*.......*.*............*......*.............*.........*.............................
.................*..............................*.*....*....*.....*.........*.....................*.
.....*...................*.......*.........*.........*..................*...........................
.............*.....................*.....*..*..................................*..*.*.......**......
.................*...*..*...............*..*........................*......*..........*.............
......................................*...............................*...............*.............
...*...............*..........................*...............*....*..*............*............*...
.........*...................**..............................*.....................*......*.........
................................*...**..*......*.........*....**...*......*......*....*.........*..*
..................*..........*...............................*....*................*.....*..........
..............................*...*.......*...*..........*......*.....**...*.........**............*
.......................*.*...*........*..*...*......*...........*............................*.....*
....................**.......*....*.....*..*..........*......................*.*....................
...............*........*.*.....**.......*........*...........*.....................................
..*.....................*...*........*.....................................*........................
*....*.......................*...........................................*....................*...*.
............*.....*.......*........*.*.......*......*...................*.......*..*...*.......*....
.................*...................*..............................*.........*.............**...*..
............*.........*.................*..*.........*......*...................*...................
..........*..........*...........*.................*.....................*.*....*..............*.*..
........*....*.............*..............*........*..*.....*...............*...*.....**...........*
*...*....................*..*.........*.*..............*...........*................................
...................*....................**.....**.*.*.......................*...*...*..........*....
...............*.*....*................*...............*.*.....*........*........*..*.........*.....
.............*................*.................*.*.........*...................*..........*....*...
............................................*..........*.......................*....................
............*.....................*....*.............*..*....*.......*.*........................**..
..*............................*...*.............*.....................*............................
.......*.......................................**....*......................*.*........*............
...............*...*......................*.*...*.........*.....................................*...
..........*................*......................*....*...................*......*...*......*......
......**........*........*.........................*.*.............*......*.........................
.........................................*......................................*..*............*...
...*.*.......*..*..*.............*................*........*.........*..............*...............
....**..........*.....................*................*.....*...*.........................*...*....
............*.........*..*.........*.....*..........................*.....*........*................
.....*......*.................*..........*.........*...........*......*...*.............*...........
....*........*.....*.........*.....................*.....**...*.................*...*...*...........
