........................**...*........*.........................................
...........*....*......................*..*...*............*............*.......
.................*......*..........*.*.....................*......*....***......
.*....................*...........................................**............
...*..........*.......................................*........*................
.........**.*........*..........................................................
.................................................*............*..............*..
................*........*.........................*............................
....................*......................*..*.....*.............*.....*.......
.......*.................*......................*...............**..............
......*............................*....*.....*.*....*.......*........*.........
......*..*......*...............................*....*..........................
.................*.....*...*.......**...................**......................
.................*.................*..*.*.......................................
..........*.....*..........................*.......**......................*....
.................**..*......................................................*...
.....*...................................*......................*..*............
*..........*..................*.....................*............*..............
.*.......*......*................*........*......*......*.*.....................
......*......*...............*....*..*.........................*........*....*.*
...................................*..*...............*.................*.......
.................*...............................*.............*................
..........................*.............*....................................*.*
..............*.....................*...*...*.....*................*.*.*.*......
........*...................*.........................*..................*..*.**
...........................*.........................*...........*..............
....................................*.......................*.*...........*.....
..*..............*...............*......*.........................*.*...........
...........*.....*................*.............*..............................*
...*.................................*........*......*...............*..........
..........**...........*..*.....*...............................................
...*...*.............................*..............*...........*...............
..............*...............................*...................*...*.........
............*.........*......*....*............*................................
...*............................................................................
*..*.....*.*...*.*..........*.........*............................*.*.....*.*..
..........................*..**..............*..............**..**..*.*.........
..................................*.............................................
.*.......*..............*.......*......................*..........*....*........
....*.*....................**...............*....*........*...........*...*.....
............................*..............*............*....*..................
........*.......*.......................*.........................*......*....*.
....*................*......*..*................................................
..*..........*..*...................................*...........*..*...*........
.......*........*.....................*..*.........................*..........*.
...........**...............*.......*.............*...**........................
*.......*........*...........*.***.*.......................*.......*..*.........
.*................*..........*..*..*.....................*.......*.*..*.*..*.*..
....*...................*...*................*............*...........*.........
..........*...................*....................*.*..*.............*.........
.............*......*...........*.........*......*..............*.............*.
......*.....*.............*.........*.*........*..........*.*..*...*..*.*.......
..*..............................*....*...........*...................*...*...*.
....*...............*.....................*.....*.................*..........*..
*.................*.............................................................
....................**......................*.....*.*..*.....**.................
......................*............*...................*...............*...*....
...*..*.*.................................*.....*...................**.*........
..*........*.*..*..................*.......................*.........*..*.......
........*...............*......*............*...............*.......*...........
............*.............*......**.....*......................................*
....*.....**.................*...**..*.*...........*.....................*......
.................*.......*..............*...*.....*.............................
......................................*.......*....*..*.........................
..........*...........................*..........*..**.....*....................
.............*................*........*.....................................*..
....*....................*.........**.............................*.............
..*..................*..*......*........*......*......*.......*..*............*.
......*....*.*...*..........*..*......................*......*.....*.*...*......
..*............*.......................*.................*.*.*.........*......*.
.................*........*.*........................*.......*..*.....*.........
.*...........................*....*......*.........***..........................
...............*....*.....*.*...........*...........................**..........
*.*..*........*.*....................*.*..........*................*...*..*.....
.......*............*........................*.........*.........*..............
...*............................***......*.........*.....................*......
...*..**......*.........*..*............*.......................................
..............*.......*.......*..............*.*.............*..................
..*.......*........*...**...................................**..........*..*....
...........*.......*.*.....*......*.........*......................*......*....*
