..........
.......*.*
..*.......
....*.....
..........
..........
..........
..........
..........
.........*
