..........
..........
..........
*.........
*.........
..........
..........
....*..*..
..*.......
..........
