......................................................................................................................................................
......................................................................................................................................................
......................................................................................................................................................
........................************..................................................................................................................
......************************************......................................................................******............****................
.....**....**...**...*...**..**..**..**.***............*********.......................**********...........************...*.....*************........
.....*****.**...**..**...**..**...*..**..*.*.....******************...............****************.......********.....***..**...****************......
.....**************************..**..**.**.*...**********************............*****************......******.........**..**...***.......*******.....
..............*************************.**.*.********.............*********************..........**....*****...........**..**...***...........***.....
.....**.............................******.******..................****************..............**....****......********..**...***********....***....
.....*****........*************.........*******..................*****....**...***...............*....****....**********...**...******************....
......******************************......****.........****************...**...*******************....***...******.....******...***....***********....
..........******************************.****.....*********************...**...************..*****....**...****......***...****************.....**....
................................************....***********........****...**...***...............*...***..****....******.........*****************....
.....*******...........................****....*****...............***************..........******...**..****...****...**........**.............**....
.....***************************.........**...****.................*******************************...**..***...****....*****************........**....
.......******************************...**...****....***********************.**************......*...**.***...***....***....**********************....
.............*****************************...***.....*****************.***...*****.............***...*..***...***...*******......***...........***....
....******.........................*******..***........******......***.***...**********************..*..**...***...***.********************.....**....
....*********************..............***..***.........**.........***.***...*************.......**..*..**...**....**..*.......*******************....
.....*****************************......**..***....**...**.........********.*****................**..*..**..***...***..*.........***............**....
........*****************************...**...**....***...**....*************************........***..*..**..***...***..****************.........**....
.........................*****************...**....***...*****************************************...*..**..***...***..*......********************....
....****.........................********....**....****..************************..........******....**.**...**...***..*.........*****************....
....**************...........................***....***..*****......**..............................***.**...***...***.**........**.......*******.....
.....******************************.........****....***..**.........**..............*.....**......*****.**...***....**.************...................
........****************************************....***..**.........**....**...**...**....**.....******.***...***...****....*******...................
.........................***********************....***..******.....**....**...**...**.........********.***...****...***.........**************.......
..................................***********.......***..*************....**...**.............*********..***...****...******.....*****************....
....********************...........................****..*************.......................*****..***..***....****.........*****....................
....****************************.................*****...**........***................**....*****...***...***....*****...........******...............
.....************************************************...***.........**..**...**...**..*....****.....****..****....*******........****************.....
............................***********************.....***.........**..**...**...**.....*****.....*****...***......*********...**....***********.....
...................................*************.......**********...**........*...*....******.....******....****.....*************....................
.....*.......***************..........................*****************..............********...*****.***....****......**************.................
....***************************...................******.....*******************************...****...****....*****.....**...**.******************....
....*************........**********..........**********......***..***.*********************...****...********.*******...**...**...***.....********....
.......***..................*************************.......***...**...***...***..**...***...****...***************************....***................
................................******************..........***...**...***...**...**...***..****...****..*******..**.**********.....********..........
....******************.....................................****..***...***...**..***...**...***....***..***...*...*..************....*************....
....****...****************.............................******...***...***...**..***...**..****...****..**...**..**..******...****...***...**..****...
...***......*****.......******...........********************....***...***..***..***...**..***....***..**....*...**..******...******..***...*..**.*...
....****..*****............******...************************.....***...***..***..**....**..***...***...**....*...*...*****....*******..**********.*...
....*********................************************............**....**...***..**....**.****...***..***...**...*...*****....**..***...*********.*...
.....*******.....******.......**********.........................**....***..***..**....**.****...***..***...*....*...***********...***..**.**..**.*...
........**.....***********......****.............................**....***...***.**....**.****...***..***...*....*...**********...*****..*..*..**.**..
.............******...******...****..............******************.....**....***********.****...***..***...*....*...**********...***************.**..
....**......****.........********...........*************************...***.....*********..***...***..***...*....*...**....*********...***...****.**..
....**.....****...******...******.........**************..***...******...***.....***...**..****..***..***...*..*.*...*......********....***....**.**..
....**....****..********...*****........*********...****..***...*******...***.....**...**...*****.**..***...*....*...*.......********..******..**.*...
....**....***..****..****...****.......******.***....***..***...***.***...****....*******.....******..***...**...*...*.......*****.******..******.*...
...........*..***.....***...***.......******...***..****..***...**...***...****...********......****...**...**...*...*.......****...*****....****.*...
..............***.**...***...**.....********...***..***...***..***...****..****...***...**.......***...***...*...**.**..**...****....****.....*****...
.............***..***..***...**....*****.****..***..***...***..**...*****...****..***...**....*...***..***...**..**.**..***..******..*****....**.**...
......**********..***...**...**....****...***...*************.***...**.***..****...**...**...***...**..***....*..**.**..***..**********.***..***.**...
.....***********.****...**...**...******...***.******************..***..**..****...*******...***...**...**....*...*.**..***..***.*****...*******.**...
....****************....**...**..********...*********************.***...***..***...*******...***...***..**.....*..*.**.****..**..******...*****.**....
....***************....***...********.***...************************....***..****..**...**...****...**..***....*..*.**.****..**..**..****...**..**....
...*******...****......***...*******...**********...........*******...*****..****..**...**...****...**...**....*..*.**.****..**..**********...***.....
...*******...***.......***...********...*******...............*************..****..**...**...****...**...**....*..*.**.****..**..****************.....
...*******...***..**...***..**********...*****.......****.......************.****..*******....***...**...**....*..*.**.****..**.**.************.......
...*******...***..***..***..******..***.****......*********......******...**..***..********...***...**...**....*..*.**.****..**.**.*..*..**...........
...*******...**...**..****..******...*******.....************.....***.....**..***.*********...***...**...**....*..*.**.***...**.**.*..*..**...........
...********.***...**..***...******....*****....******...******....***.....**..***.***...***...***...**...**...**..*.**.***...**.**.*.**..***...**.....
...************...**..***...*****......***.....****.......*****....*********..***.***...***..****...**...**...**..*.**.***...**.*******..***...**.....
...************.......***...********..****....****.........****....*********..***.****..***..****..***...**...**..*.**.***...**.*******..***...**.....
...*************...........***************...****......**..****....**.....**..***.*********..****..***...**...**.**.**.***...**.*.**.**...**...**.....
...*******...*****************.**********....****....****...****...**.....**.****.*********..***...**...***...**.**.**.***...**.*.**.**...**..........
...*******....***************......******...****.....****...****...***...***.***.****.*****..***...**...***...**.**.**.***...**.*.**.**...**..........
...*******....***************........****...****....****...*****...*****.***.***.***....***..***...**...***...**.**.**.***...**.****.**...**..........
...*******....****.**********........****...****....***...******...********..***.***.....**..***...**...***...**.***.*.***...**.*******...**..........
...***************..**...****...***..****...****....****.******...**.******.****.**********..***..***...***...**.*.*.*.***...**.*******...**..**......
...**************...**...****...***..****..****.....***********...**...****.****.**********..***..***...***...****.***.***...**.*.**.**....*.***......
...**************...**...****...***..****..****.....**********....**...***..***..**********..**...**...****...**.*.***.***...**.*.**..**...*..**......
....*******************.*****...***..***...****.....*********....****.***..****.***.....***..**...**...****...*..*.***.***...**.*.**..**...*..**......
.....*....*******************...**...***....****....*********....********..***..***......**..**..***...***...**.******.***...**.****..**...*..........
.....*.....******************........***....****....********....********..****..*******..**..**..***..****...**.*.*.**.***...**.********...*..........
.....************************........***.....****....*******....*....**...***...***********..**..***..****...**.*.*.**.***...**.*********..**....**...
.....********............*****.......****....*****....*******..**...***..****.........*****..**..**...***...**..*.*.**.***...**.**.**..**..**....**...
....**.....**.............***************.....*****.....**********..**...***............***..**..**...***...**..*..**..***...**.**.**..**...*....**...
....*********...**....**..***************......*****......************..****.********....**..**..**...**....**..*****..***...**.**.**...**..*....**...
....********...***....**..***************........*****.....**********...***************..**..*...**...**...**......**..***...**.**.**...**..**........
....**.....*...***....**..***************.........****.....****..****..*******.....****...*..*...**..***...**......*...***...**.**********...*........
....**.....*..........**..***************..........****.....***...***..*****........****..*.**...**..***...**.....**...***...**..**********..**.......
....********..............***************...........****....***...***..****.....**...***..*.**...**..***..***.....**..***...***..**********..**..***..
...*********...............*************.............***....***...**...***......**...***..*.**...**..***..***....***..***...***..*..*....**..**..***..
...**......*..**....*......*************.............****...***...**...***......**...***..*.**...**...**..***....**...***...***..**.**...**...**.***..
...*****...*..**...***......**********....***.........***...********...****....***...****.*.**...**...**..***...***...**...***..*********.**..**......
...*********..**...***........******......****........***...********...****....***...****.*.**...**...**..***...***..***...***..************..**......
...*********..**....**.....................****........***..*********...*********....***..*.**...**...**..***...***..***..****..****.....***..**......
...**......*................................****.......***..***..****...********....****.**.**...**...**..***..***...**...***..***..**....**..***.....
...***.....*............***...........**.....****......***..***...***.....****......****.**.**...**...**..***..***...**...***..**..****...***..**.....
...*********............***...........**.......***......**..****..****.............****..**.**...**...**..***..***...**..****..**....***...**..**.....
...**********...........***....**.....**........***.....**...***...***...........******.**..**...**...**..***..***...**..***...**.....**...**..**.....
...**......**....**...........****...............**.....**...****..*****......********..**..**...**...**..***..****..**..***...*****..**...**..**.....
...**......**....***..........****.........**....***....**...****...*****************..**..***...**...**..***..****..**..***...****..***..***.***.....
...**********....***..........****........*****...**....**...*****....*************....**..***...**...**..***..****..**..***.........***..**..***.....
...**********....***....*.......*........*******..**....**...******.....********......**...***...**...**..***..****..**...***........**...**..**..*...
...**.....***....***...**................***.***..**....**...**.****.................**....**....**...**..***...***..***..***.......***..***..**.**...
...**......**.....*....***..........**...**.......**...***...**..******...........****....***...**....**..***...***..***..************...**..***.***..
...**********..........**..........***...***......**...***..***...*******************.....***...**...***...**...***..***...**********...***..***.**...
....*********......................***...****....***...***..***....***************.......****...**...**....***..***..****..**********..***..***.......
....*.....***...**..................**....**********...***..***....***....***...........*****..***...**....***..***..*****..********..****.****.......
....*......**..***.........................********...***...***....***.....**..........*****...**....**....***...**..*****.....*.....*****.***........
....*********..***...........................*****....***...***...*******..***....*********...***...***....***...**...******.......**********.........
....********....*..***********........................***..****...*******..**************....****...***....***...***..***.****************.**....**...
.....*....**......****************************.....**********************..***********.......***...****....***...***..****..*******....**..**...****..
.....*....**.....*.....*....**.....**...********************..***********..*******.........****....****....***....**...*****..**.**....******....***..
.....*******....********....**.....**....**....*******..***...***...*****..****..........******...*****....***...****...*******...*********.**...**...
......******....******************************************....***....****..***......**********....******...***..*****.....******..********..**........
......*...**...**.....**....**....*********....**...******....***....****..**..*************.....***.***...**.**********....********....**..**........
......******...**.....**....**.....**....**....**...*...****..***...*****..***********..........****.***...**.*.**..******....******....******........
.....*.*****..****....**....**.....**....**..****...*...****************..*********............****..***..***.*.*..**.*****.....****...*******...**...
.....**.***..*************************...**************..**********..**..*********...........*****...***..***.*.*..*..*.*****....**********..**..**...
......**....******************....**********...**...*******....***..***..*********.......********...****..**..*.*..*.**.*.****....******.***.**..**...
......***..***.*.....***....**....**.....**....*....*.*****....***.***..*********......*********....****..**.**.**.*.*.**.*****....***....**..*..**...
........*****..**....***....**....**.....**....*....*..****.....*****...*********.....*******......****..***.*.**..*.*.*****..***...**....***.**......
....**.........***************************************.*****.********..**********....*****........*****..***.*.**.**.*.**.*...****..**...****..*......
.....**......********************************************.**********...**********....***........******...***.*.**.**.*.*..*..*****...************.....
.....****...******....**....**...**...***....*....**.****.****..***...***********....**.......**************.*.**.**.*.*..****.****..******..****.....
.......*******...*....**....**...**....**....*....*...*******..****...***********...***......***************.*.**.**.*.*...**.**.***.***.**..**.*.....
..........**.....*.....*....**...**....**...**...**...*******.****....***********...***....******......*****..***.****.*...*****.****.**..*..**..*....
....**.........****..*******************************..**..********...************...**....*****..........***..*.*..*.*.*....**.*.**.*.**..******.*....
....*************.************************..************..*******....************...**...****.............***.*.*..*.*.**.****.*.**.*.**********.**...
......**********..*********.***.**..**..**..**.***.******.*******....************...**...****....******....**.*.*..*.*.*...*.*.*.**.*.******..*****...
..........****....******.**..**.**..**..**..**.***.*********..***....************..***...***....********...**.*.**.*.*.**.**.*.*.**.*.**...*..***.*...
.................****..*..**.**.***.**..**.***.**..***.****...***....************..***..****...***..*****...*.**.*.*.*.**.**.***.**.*.***..******.*...
....*****.....*****.**..*.*****..**.**..**.**.***.***..****...***....***********...***..****...**.....****..**.*.*.*.*.**.*..***.**.*.********.**.**..
....**************..***.**.**.**.**.**..*.***.**..***.*****...***.....**********....**..****...**......***..**.*.*.*.*.**.*..***.**.*.**...**..**.**..
.....***********....****************************..**..*****....***.....*********....**...***...**..*....**...*.*.*.*.*.**.*..***.**.*.**...**..**.**..
..................**********************************.**.***....****........*****....**...***...***......***..*.*.*.*.*.**.*..***.**.*.***********.**..
................**************..***********************..***...*****.......*****....***..***...***......***..*.*.*.*.*.**.*..***.**.*.***********.**..
..........********************...***....***************..***....*****.....*******...***..***...***..*...***....*.*.*.*.****..*.*.**.*.**...**...*.**..
.......***************...*****...***....***....********...***....****************....**...***..***..*...***....*.*.*.*.*.**..*.*.**.*.**...**...*.**..
......****************...*****...***....***....***.****...****....***********.***....**...***..***......***....*.*.*.*.*.*...*.*.**.*.***********.**..
.....************.************...***....***...****..***....****.....********...**....**...***...**......***....*.*.*.*.*.*...*.*.**.*.**...**...*.**..
.....***********..************...***....***...***...****....****.......**......***...**...***...***..*..***....*.*.*.*.*.**..*.*.*..*.**...**...*.**..
.....****..******.************...**********...***...*****....*****............****....**...**...***..*..***....***.*.*.*.**..*.*.*..*.***********.*...
....****...**************************************...******....******.........*****....**...***..***.....***....***.*.*.*.*****.*.*..*.**...**...*.*...
....*********************..**********************...**..***....********...*****.***...**...***...**.....***...****.*.*.*.**.*..*.*.**.**...**.*****...
....***************..************...........****************.....*************..***...**...***...***.....***..*.*.**.*.*.**.*.**.*.**.*************...
....**************...********...................**************.....*********....***...**...***...***..*..***..*.*.**.*.*.**.*.*.**.*..*******..****...
....********..*****.********........**...*.........************................****...**...****..***..*..***..******.*.*.**.*.*.**.*..........**.*....
....********..************......**..**...**..**...........*******.............*****...**...****..***.....***...*******.*.**.*.*.**.*.....*****..*.....
.....********************......***..**...**..**...**....**..********.......****..**...**...****...**.....***...*******.*.**.*.*.*..*..*****....**.....
......*****************.........**..**...*...**...**....**....****************...................................*****.*.**.*.*.*..*......*****.......
........************..........................*...**....**.......***********...........................................*......*.*.....*****...........
.............***......................................................................................................................................
......................................................................................................................................................
......................................................................................................................................................
