..**.....*........*.............................................................
........................*.....*..........................*.....*................
....*......*.*.*....*...........*...............*...............*..............*
..*.....*.......................................................................
............................*....................................*.......*......
................*...........................*.................*.................
..*................*........*.....*................................*.*..........
.........*.....*............*....*..............................................
...........*....................**...............................*...*..........
...*........................*..........*........................................
*...*.........*......................*.............................*...........*
......................*.*.....*.............................*...........*...*...
.............*..*.........................**.....................*.......*...*..
.....................*...*.......*....................*.........................
........................*......................................................*
....................*.......*...............................*...................
.*.............................**.*.........................*.....*....*...*.*..
............*........*...................*.......*...*..............*.......*...
...........*.....*................*..........*............*.....................
............*..*..*.......*.......................**.................*......*...
.......*......................................*............*....................
.....*.........................*...............*..........................*.....
..*.*..........*.........................................*....................*.
..........**.......*......................*..........*.................*........
..................*...........................................**................
.......................*..............................................*...*.....
.........*......*......*...........................*.........*..................
..............................*......*......*........*..........*..........*....
.............................*................*................*...*............
.............*.*................................**..............................
........*.............................*.*........*.........*..................*.
..........................*..................*..*...*..........*.....*..........
......................................*.............*...........................
..............*.*..................*.......*........*..................*.....*..
....*.*........*..................*.....................*.....*.*.........*.....
..............*.....................*...*....*.*.*......*.......................
................*.........*....**....................*..........................
...........*.......*.....*................*..............*............*..*....*.
.........*...............*......................*...........*...............**..
....................*.....*....*........*.............*..........**.............
......................*..............................*..........................
....*.....................*......*.*...*...*............*.......................
.......................................*........................................
............................*....*........................*...........*........*
................*.......*.......................*..*....*..*..............*.....
.......*..............**.........................*......*...........*...*.......
......*.............*............*..............*....*......................*...
*....................*...*......................................*...............
................**......*....*.*..........*.......*.*..*...*............*.......
.*...................................................*...*............*.........
.........*.............*...*............................................*.......
...*......*...............................*..*.....*......*.................*...
..............................*........*....**......................*...........
................................*..*....*........*.....*......................*.
..............*..........................................*.........*.*.*........
...*.........*...........*.....*..........*....*..........................**....
*.........................................................*.....................
....*.....*..........*....................*....*..........*.................*...
.......*......................*.....................*.............*.............
.........*.......................................*........*.....................
............*..................*...**..*......................*..........**.....
....*............*.............................*..........................*.....
............................*.....*................................*............
............................**........*.........................................
..............................*.....*.*.............*..........*........*.......
..................................*.................................*...........
..............................*......................*.........*.....*.........*
...........................*..**.................*.....*................**......
...........*...*.................................................*.**.*.........
............*..........................................*..**....................
............................*.*......................................*....**....
.........*................................*.....................................
.............*......................*......*..........*...**.*..................
......*.........................................................................
.....*...............*...............*.........*.......................*........
......*..*........**...........*.......*...............*.........*....*.........
...............*........*...................*...*.............................*.
.....*...................................*.........................*.*.....*....
..........................................................*.*...................
......*.........................................................................
