.*.......*
....*.....
..........
.....*...*
....*....*
..*....*.*
..........
*.........
...**.....
......*.*.
