......................*..*.........*................................................................
....*.......*..........................................*............................................
.................................*.....................................................**...........
..............*..........................*................................................*.........
........*.*............*........................*.................*...*...*........*................
.......**.......................................*...........*.......................................
........................................................................*...........................
.....................*..............*...........*......*.............................*..............
............................*...........................*...........................................
.......................*............................*..................*.....*......................
*............*.*...............*................................*...................**......*.......
.........*...............................*......................................................*...
.*....*........................................*.............*.........*.......*.......*............
................................*.........*.......................................**.............*..
........*..*.....***...........................*...........................*........................
...*....................*..*............................*...........................***.............
........*......*...............................*............*.....*.............*...................
........*..............*..........................*.*..............*...........................*....
...*..............................*..............................*....*.........*.............*.....
..............................................................................................*.*...
.....................................*...........................................*.....*.......*....
.........*.....*.......*..............*.................*..*.......................................*
..*.............................................*....*..*.....*.........*.................*.........
.....................................*.....................................................*...*....
.......................................................................................*.......*....
....*.................*.....................**................................*.....................
........*..........*...................*.............................*.........*....................
...*...*..............*.............*...............................................................
.............................*...*.............*....................................................
......*.....................................................................*..............***..*...
.....................*.................*................*.*.................*.............*.*.......
................*.........*.............*.............*..........................*.*......*..*......
....*............................................*..........*...................................*...
..*...*.....*........*........*.............*...............*.......................................
...................*...........*..........................**...................................*....
.........................................................................*...................*.....*
........................*....*...........*........*.....................................*......**...
..*...........................*......*.............*....*...........................*...............
......................*............................*...*................................*.........*.
....................................................................................*...............
.....*.....*.*.....*.............*........................*.*......................*......*.........
...*....*............................*............*..............*...................*..*.......*...
............*...............*.......*....*..................*..........*.*..........................
..............................*................*..........*..................................*..*...
....*..............*...*..........*..............................................*..................
*....................................................................*..............................
........................................*...........*...............................................
..........................*....................*.........*..........*.*....................**.......
.*..*........*.........*.......................*........................*.................*.........
..............................................*................*.......................*............
.......*.*..................*...............*...............................**.......*..............
....................*.......................................*..................*...............***..
...................*..................................................*....*........................
.........*.........................................*.....*..........*...............................
...........*.....*.................*................................................................
............*....................................................*..................*...............
..............................................*........*..*..*......................................
....*..........*.................*.....*..*..*......*.......................................*.......
......*..........*.............*............................*....................*...........*......
...............................................*.........................*..................*.......
.*..............................*.*.................*.*....................*.........*............*.
............*...............*.................................*....*...............................*
...........*...............*......................*.........................................*.......
...........*...........**.............*............................*...*.................*..........
.......*..........*...............*...........................*......*.....*........*...............
............*..................................*.....*....*................................*........
.*........*.........................*..................*................**..........................
....*.................*.............*....*......*....*...*...................................*......
........*..........*.*.........**.......*...*.............*..................................*....*.
*.................*.*...........*.....*...................**................*..*....................
..........*.................................*...............................*.......................
.............................................................*................................*.....
..........*....*.............**.....................................................................
....**.......*..............*...............................*.............*......*.....*............
................................................................................*..........*........
....*..*...*......................................................*.................................
..........................................................*....*.*........*............*......*.....
.........*...........*..........*.......................*......*.............................**.....
...*.......................................................*......*............*..................*.
.....*..*........................*................*................*...*..........*...*.........*...
..........................................*..........*............*.*......*..........*.......*.....
...*..................*...........*..*..*....*......................................................
.....*.......................*.............*......*.......*.................*.....*...........*.....
......*..............*......................................*...........................*..........*
........*.......................................*.......*....................*......................
............................*.................................................*.....................
.........................................................*......*......*......*....................*
.................*....................*............*.**...*.............*...........................
..........................*...................*...............*............*..................**....
...........*...............*....*...................................................................
................................................*...........*......................*..............*.
...............................*..*.....................................*.*.......*.................
.........................................................*.....................*....................
..................*..............................................*..........*...................*...
.............................*....*..............*......................................*...........
..........................*.........................................................................
........**...**.....................................................................................
..............................*..............*......................................................
...........................................*...................*....................................
..............*.........*................*......................................*.....*....*........
