...............
*.........*....
...............
...*...........
*......*..*..*.
..*.......*....
..*..*.........
...............
...............
........*....*.
...**.....*....
.....*...*.....
.....*.*.....**
.*..*..........
..............*
