....................
...*..*....*........
.*..................
..................*.
.............*......
.................*..
...........*........
.....*.*........*...
*.*.................
*...................
..*.................
....................
*......*......*.....
....................
..*............*....
....................
....*..........*....
.....*..............
..*.................
..............*.....
