....*....*...*.**........*....
........*...*.*......*........
.....*....*.....*........*....
..............................
*..*..*....................*.*
...*...........*.*..*.*..*...*
.........................*....
.....*....*..*................
..........*.....*.*...........
.............*.*....*.......**
...*............*..........**.
...........*.*.........*......
.......*...........*..........
....**.........*.......*......
..*.*.**......**..*.....*.....
*.*....*....*.................
*.*...........................
.............*..............*.
*......*........*.*....*...*.*
.....**..*....................
..........*..........*........
................*.............
..............*.*.*...........
....**.*..*.........*........*
..*..............*.....*......
...*....*.....................
.....*.........*.....*........
.....*..............*.**......
..........*.*...........*.....
..................*...........
