..........
.*....*...
..........
...*.....*
..*...**..
..........
..........
.*.......*
.....*....
..........
